subj,trialExp,trialRoom,rt,signedPE,reward,estimate,absPE,risk,signedErr,absErr,learningRate,lrcat,deck
1,0,0,4962,-40,20,60,40,1,20,20,0.75,-50,40
1,1,1,3363,0,60,60,0,1,0,0,,,60
1,2,2,4099,50,80,30,50,1,-10,10,0.6,50,40
1,3,3,4678,-30,20,50,30,1,-10,10,-0.666666667,-30,60
1,4,4,5784,-60,0,60,60,1,20,20,0.666666667,-50,40
1,5,5,3378,40,60,20,40,1,-20,20,0.5,50,40
1,6,6,3857,30,100,70,30,1,10,10,0.333333333,30,60
1,7,7,3871,0,80,80,0,1,20,20,,,60
1,8,8,3742,0,40,40,0,1,0,0,,,40
1,9,9,3736,-10,40,50,10,1,-10,10,3,-10,60
1,10,10,3550,80,100,20,80,1,-40,40,0.75,70,60
1,11,11,3668,20,60,40,20,1,0,0,0,10,40
1,12,12,3839,-40,0,40,40,1,0,0,0.25,-50,40
1,13,13,4127,-40,40,80,40,1,20,20,1.25,-50,60
1,14,14,4807,50,80,30,50,1,-10,10,0.6,50,40
1,15,15,3698,-10,20,30,10,1,-30,30,-3,-10,60
1,16,16,4441,-40,20,60,40,1,20,20,0.75,-50,40
1,17,17,4410,20,80,60,20,1,0,0,0,10,60
1,18,18,3657,0,60,60,0,1,0,0,,,60
1,19,19,4438,10,40,30,10,1,-10,10,1,10,40
1,20,20,4406,40,80,40,40,1,0,0,0.25,50,40
1,21,21,4074,-70,20,90,70,1,30,30,0.428571429,-70,60
1,22,22,3836,40,100,60,40,1,0,0,-1.4,50,60
1,23,23,3310,-10,40,50,10,1,10,10,4,-10,40
1,24,24,4657,56,60,4,56,1,-56,56,0.821428571,50,60
1,25,25,3981,50,60,10,50,1,-30,30,1.4,50,40
1,26,26,4275,30,80,50,30,1,-10,10,1,30,60
1,27,27,4210,-60,20,80,60,1,40,40,0.666666667,-50,40
1,28,28,3621,-40,0,40,40,1,0,0,,-50,40
1,29,29,3315,-40,40,80,40,1,20,20,,-50,60
1,30,0,3671,10,70,60,10,0,0,0,-2,10,60
1,31,1,3239,10,30,20,10,0,-20,20,4,10,40
1,32,2,4503,-20,40,60,20,0,20,20,-0.5,-10,40
1,33,3,3506,40,80,40,40,0,-20,20,-0.5,50,60
1,34,4,5143,40,60,20,40,0,-40,40,1.5,50,60
1,35,5,7170,-20,50,70,20,0,30,30,0.5,-10,40
1,36,6,4347,-40,20,60,40,0,20,20,1.125,-50,40
1,37,7,3944,-40,40,80,40,0,20,20,0.25,-50,60
1,38,8,6003,45,60,15,45,0,-25,25,1.444444444,50,40
1,39,9,3478,-20,50,70,20,0,10,10,-0.5,-10,60
1,40,10,4846,-30,50,80,30,0,40,40,1.666666667,-30,40
1,41,11,3448,-20,60,80,20,0,20,20,1,-10,60
1,42,12,6568,-10,50,60,10,0,0,0,-1,-10,60
1,43,13,3369,0,30,30,0,0,-10,10,,,40
1,44,14,4006,0,70,70,0,0,10,10,,,60
1,45,15,4526,0,40,40,0,0,0,0,,,40
1,46,16,3806,-50,40,90,50,0,30,30,-0.2,-50,60
1,47,17,4495,40,60,20,40,0,-20,20,0.25,50,40
1,48,18,5341,-20,80,100,20,0,40,40,0.5,-10,60
1,49,19,4600,-10,20,30,10,0,-10,10,1,-10,40
1,50,20,3896,-30,60,90,30,0,30,30,0.333333333,-30,60
1,51,21,3823,-10,70,80,10,0,20,20,2,-10,60
1,52,22,3474,30,50,20,30,0,-20,20,0.666666667,30,40
1,53,23,4370,0,40,40,0,0,0,0,,,40
1,54,24,4389,20,80,60,20,0,0,0,1.5,10,60
1,55,25,4915,-10,30,40,10,0,0,0,2,-10,40
1,56,26,5111,40,60,20,40,0,-20,20,0.5,50,40
1,57,27,3738,-50,40,90,50,0,30,30,1.4,-50,60
1,58,28,3686,30,50,20,30,0,-40,40,,30,60
1,59,29,4052,-20,20,40,20,0,0,0,,-10,40
2,0,0,4632,-14,20,34,14,1,-6,6,-3.785714286,-10,40
2,1,1,4695,58,100,42,58,1,-18,18,0.275862069,50,60
2,2,2,5426,-47,40,87,47,1,47,47,1.319148936,-50,40
2,3,3,4095,-18,40,58,18,1,-2,2,0,-10,60
2,4,4,3672,-25,0,25,25,1,-15,15,-1.24,-30,40
2,5,5,3900,4,60,56,4,1,16,16,3.25,10,40
2,6,6,3497,2,60,58,2,1,-2,2,-8,10,60
2,7,7,3669,-22,20,42,22,1,-18,18,-1.863636364,-30,60
2,8,8,4600,11,80,69,11,1,29,29,-1.909090909,10,40
2,9,9,5215,-3,80,83,3,1,23,23,13.33333333,-10,60
2,10,10,4329,57,100,43,57,1,-17,17,-0.754385965,50,60
2,11,11,7013,-8,40,48,8,1,8,8,2.75,-10,40
2,12,12,4140,-26,0,26,26,1,-14,14,-0.346153846,-30,40
2,13,13,3819,60,60,0,60,1,-60,60,1.233333333,50,60
2,14,14,4655,45,80,35,45,1,-5,5,0.933333333,50,40
2,15,15,6394,6,80,74,6,1,14,14,-1.666666667,10,60
2,16,16,5339,-57,20,77,57,1,37,37,-0.052631579,-50,40
2,17,17,4400,-44,20,64,44,1,4,4,0.727272727,-50,60
2,18,18,3714,8,40,32,8,1,-28,28,-1.5,10,60
2,19,19,4475,-20,60,80,20,1,40,40,1.3,-10,40
2,20,20,4599,6,60,54,6,1,14,14,-7.333333333,10,40
2,21,21,3820,0,20,20,0,1,-40,40,,,60
2,22,22,5206,7,100,93,7,1,33,33,-8.857142857,10,60
2,23,23,4634,70,80,10,70,1,-30,30,0.214285714,70,40
2,24,24,5154,29,60,31,29,1,-29,29,0.379310345,30,60
2,25,25,4632,15,40,25,15,1,-15,15,0.2,10,40
2,26,26,5297,-2,40,42,2,1,-18,18,12.5,-10,60
2,27,27,4636,-8,20,28,8,1,-12,12,-6.5,-10,40
2,28,28,4209,-80,0,80,80,1,40,40,,-70,40
2,29,29,5573,63,80,17,63,1,-43,43,,70,60
2,30,0,5349,37,70,33,37,0,-27,27,1.135135135,30,60
2,31,1,4634,-25,40,65,25,0,25,25,1.68,-30,40
2,32,2,4691,7,30,23,7,0,-17,17,5.285714286,10,40
2,33,3,4752,-25,50,75,25,0,15,15,1.96,-30,60
2,34,4,5412,34,60,26,34,0,-34,34,0.852941176,30,60
2,35,5,4187,-40,20,60,40,0,20,20,0.5,-50,40
2,36,6,4538,10,50,40,10,0,0,0,-2,10,40
2,37,7,4866,25,80,55,25,0,-5,5,1.4,30,60
2,38,8,4780,40,60,20,40,0,-20,20,0.625,50,40
2,39,9,4818,-50,40,90,50,0,30,30,0.2,-50,60
2,40,10,4890,15,60,45,15,0,5,5,-0.866666667,10,40
2,41,11,5121,0,80,80,0,0,20,20,,,60
2,42,12,4926,-17,60,77,17,0,17,17,3.235294118,-10,60
2,43,13,7015,-2,30,32,2,0,-8,8,0,-10,40
2,44,14,3341,18,40,22,18,0,-38,38,0.166666667,10,60
2,45,15,4433,-12,20,32,12,0,-8,8,-1.5,-10,40
2,46,16,4726,45,70,25,45,0,-35,35,0.622222222,50,60
2,47,17,4635,-10,40,50,10,0,10,10,-1.5,-10,40
2,48,18,5511,-3,50,53,3,0,-7,7,-9,-10,60
2,49,19,5133,-15,50,65,15,0,25,25,3,-10,40
2,50,20,5144,-30,50,80,30,0,20,20,1.333333333,-30,60
2,51,21,4342,40,80,40,40,0,-20,20,-0.25,50,60
2,52,22,3994,40,60,20,40,0,-20,20,0.75,50,40
2,53,23,3842,0,50,50,0,0,10,10,,,40
2,54,24,3505,10,40,30,10,0,-30,30,1,10,60
2,55,25,3430,-30,30,60,30,0,20,20,0,-30,40
2,56,26,3593,-40,20,60,40,0,20,20,0,-50,40
2,57,27,3929,20,60,40,20,0,-20,20,2.5,10,60
2,58,28,3682,-20,70,90,20,0,30,30,,-10,60
2,59,29,3416,-20,40,60,20,0,20,20,,-10,40
3,0,0,5929,-10,60,70,10,0,10,10,0,-10,60
3,1,1,3019,-10,30,40,10,0,0,0,1,-10,40
3,2,2,2531,30,60,30,30,0,-10,10,0.666666667,30,40
3,3,3,2753,-20,50,70,20,0,10,10,0.5,-10,60
3,4,4,2943,20,80,60,20,0,0,0,0.5,10,60
3,5,5,2691,0,50,50,0,0,10,10,,,40
3,6,6,2879,-40,20,60,40,0,20,20,0.75,-50,40
3,7,7,2975,0,70,70,0,0,10,10,,,60
3,8,8,2667,10,40,30,10,0,-10,10,1,10,40
3,9,9,2559,-10,40,50,10,0,-10,10,-2,-10,60
3,10,10,3118,10,50,40,10,0,0,0,-1,10,40
3,11,11,4464,0,70,70,0,0,10,10,,,60
3,12,12,3048,-10,60,70,10,0,10,10,0,-10,60
3,13,13,3147,0,30,30,0,0,-10,10,,,40
3,14,14,2760,-20,50,70,20,0,10,10,0,-10,60
3,15,15,3208,0,40,40,0,0,0,0,,,40
3,16,16,3415,-30,40,70,30,0,10,10,0.333333333,-30,60
3,17,17,4346,0,60,60,0,0,20,20,,,40
3,18,18,2640,20,80,60,20,0,0,0,0.5,10,60
3,19,19,3392,-30,20,50,30,0,10,10,1,-30,40
3,20,20,2523,-20,50,70,20,0,10,10,2,-10,60
3,21,21,2669,40,70,30,40,0,-30,30,0.75,50,60
3,22,22,3211,20,40,20,20,0,-20,20,0.5,10,40
3,23,23,2624,0,30,30,0,0,-10,10,,,40
3,24,24,3979,0,60,60,0,0,0,0,,,60
3,25,25,4049,-40,20,60,40,0,20,20,0.5,-50,40
3,26,26,2982,20,60,40,20,0,0,0,-1,10,40
3,27,27,2608,-30,40,70,30,0,10,10,0.666666667,-30,60
3,28,28,2647,30,80,50,30,0,-10,10,,30,60
3,29,29,2737,30,50,20,30,0,-20,20,,30,40
3,30,0,2851,40,60,20,40,1,-20,20,0.75,50,40
3,31,1,2619,0,40,40,0,1,-20,20,,,60
3,32,2,3870,-50,0,50,50,1,10,10,0,-50,40
3,33,3,2648,20,60,40,20,1,-20,20,0.5,10,60
3,34,4,3232,-10,40,50,10,1,10,10,-1,-10,40
3,35,5,3256,20,80,60,20,1,20,20,0,10,40
3,36,6,2673,30,80,50,30,1,-10,10,0.333333333,30,60
3,37,7,3127,-40,20,60,40,1,0,0,0.75,-50,60
3,38,8,3607,-40,20,60,40,1,20,20,-0.25,-50,40
3,39,9,3233,70,100,30,70,1,-30,30,0.428571429,70,60
3,40,10,3472,-20,40,60,20,1,0,0,2,-10,60
3,41,11,3665,10,80,70,10,1,30,30,-4,10,40
3,42,12,3550,30,60,30,30,1,-10,10,0.666666667,30,40
3,43,13,2511,80,100,20,80,1,-40,40,0.5,70,60
3,44,14,3672,-50,0,50,50,1,10,10,,-50,40
3,45,15,4446,-40,20,60,40,1,0,0,0.5,-50,60
3,46,16,3368,,40,,,1,,,,,40
3,47,17,3673,20,60,40,20,1,-20,20,0.5,10,60
3,48,18,3648,30,80,50,30,1,-10,10,0.666666667,30,60
3,49,19,2966,-30,20,50,30,1,10,10,0,-30,40
3,50,20,3281,10,60,50,10,1,10,10,1,10,40
3,51,21,3136,10,80,70,10,1,10,10,0,10,60
3,52,22,3871,-10,60,70,10,1,10,10,0,-10,60
3,53,23,2864,20,80,60,20,1,20,20,0,10,40
3,54,24,2551,30,100,70,30,1,10,10,0,30,60
3,55,25,3974,-20,40,60,20,1,20,20,0,-10,40
3,56,26,3664,-30,40,70,30,1,10,10,0.666666667,-30,60
3,57,27,2611,-40,20,60,40,1,20,20,0,-50,40
3,58,28,3624,-60,0,60,60,1,20,20,,-50,40
3,59,29,3176,-30,20,50,30,1,-10,10,,-30,60
4,0,0,5699,-30,0,30,30,1,-10,10,-0.666666667,-30,40
4,1,1,3781,-20,40,60,20,1,0,0,1.75,-10,60
4,2,2,7005,30,80,50,30,1,10,10,1,30,40
4,3,3,3652,55,80,25,55,1,-35,35,0.272727273,50,60
4,4,4,3549,-40,40,80,40,1,40,40,0.5,-50,40
4,5,5,3620,-40,20,60,40,1,20,20,0.25,-50,40
4,6,6,2899,20,60,40,20,1,-20,20,-0.5,10,60
4,7,7,2618,70,100,30,70,1,-30,30,0,70,60
4,8,8,3331,10,60,50,10,1,10,10,-1,10,40
4,9,9,2804,-10,20,30,10,1,-30,30,2,-10,60
4,10,10,4188,50,60,10,50,1,-50,50,0,50,60
4,11,11,3022,-40,0,40,40,1,0,0,0.5,-50,40
4,12,12,4202,20,40,20,20,1,-20,20,2,10,40
4,13,13,2939,90,100,10,90,1,-50,50,0.555555556,70,60
4,14,14,2828,20,80,60,20,1,20,20,-3,10,40
4,15,15,3852,20,80,60,20,1,0,0,-1.5,10,60
4,16,16,2806,60,60,0,60,1,-40,40,1,50,40
4,17,17,3539,10,40,30,10,1,-30,30,1,10,60
4,18,18,2884,-20,20,40,20,1,-20,20,0.5,-10,60
4,19,19,3982,-40,20,60,40,1,20,20,1.25,-50,40
4,20,20,3399,50,60,10,50,1,-30,30,0.2,50,40
4,21,21,3165,-10,20,30,10,1,-30,30,-2,-10,60
4,22,22,3224,50,100,50,50,1,-10,10,-1,50,60
4,23,23,4420,0,20,20,0,1,-20,20,,,40
4,24,24,3017,40,40,0,40,1,-60,60,1.5,50,60
4,25,25,3153,-30,0,30,30,1,-10,10,0,-30,40
4,26,26,3232,0,60,60,0,1,0,0,,,60
4,27,27,3180,50,80,30,50,1,-10,10,0.6,50,40
4,28,28,2923,-20,40,60,20,1,20,20,,-10,40
4,29,29,3043,80,80,0,80,1,-60,60,,70,60
4,30,0,7003,,70,,,0,,,,,60
4,31,1,3905,30,60,30,30,0,-10,10,-0.333333333,30,40
4,32,2,3339,30,50,20,30,0,-20,20,0.333333333,30,40
4,33,3,3449,-20,40,60,20,0,0,0,0,-10,60
4,34,4,4180,20,80,60,20,0,0,0,0,10,60
4,35,5,4569,-10,20,30,10,0,-10,10,0,-10,40
4,36,6,3503,10,40,30,10,0,-10,10,-1,10,40
4,37,7,3329,0,60,60,0,0,0,0,,,60
4,38,8,2847,10,30,20,10,0,-20,20,-1,10,40
4,39,9,2918,0,50,50,0,0,-10,10,,,60
4,40,10,3062,40,50,10,40,0,-30,30,0.5,50,40
4,41,11,4007,-40,40,80,40,0,20,20,-0.5,-50,60
4,42,12,3506,-30,70,100,30,0,40,40,1.333333333,-30,60
4,43,13,4050,30,60,30,30,0,-10,10,0.333333333,30,40
4,44,14,3149,-10,50,60,10,0,0,0,-1,-10,60
4,45,15,3693,0,40,40,0,0,0,0,,,40
4,46,16,3848,10,80,70,10,0,10,10,1,10,60
4,47,17,3022,-10,30,40,10,0,0,0,3,-10,40
4,48,18,3602,-20,60,80,20,0,20,20,2.5,-10,60
4,49,19,3177,10,20,10,10,0,-30,30,0,10,40
4,50,20,5578,30,60,30,30,0,-30,30,1.666666667,30,60
4,51,21,5214,-40,40,80,40,0,20,20,0,-50,60
4,52,22,3065,30,40,10,30,0,-30,30,0.333333333,30,40
4,53,23,3125,10,30,20,10,0,-20,20,1,10,40
4,54,24,3509,-30,50,80,30,0,20,20,0.666666667,-30,60
4,55,25,3028,-10,20,30,10,0,-10,10,0,-10,40
4,56,26,3040,20,50,30,20,0,-10,10,-1,10,40
4,57,27,4174,10,70,60,10,0,0,0,-1,10,60
4,58,28,3435,30,80,50,30,0,-10,10,,30,60
4,59,29,3746,50,60,10,50,0,-30,30,,50,40
5,0,0,3823,10,60,50,10,0,-10,10,1,10,60
5,1,1,3060,-20,30,50,20,0,10,10,1,-10,40
5,2,2,2936,30,60,30,30,0,-10,10,0.333333333,30,40
5,3,3,2787,-10,50,60,10,0,0,0,1,-10,60
5,4,4,3884,-10,40,50,10,0,-10,10,-1,-10,60
5,5,5,2815,10,50,40,10,0,0,0,1,10,40
5,6,6,2854,-10,40,50,10,0,10,10,1,-10,40
5,7,7,2865,10,70,60,10,0,0,0,0,10,60
5,8,8,2981,-20,20,40,20,0,0,0,0,-10,40
5,9,9,2763,20,80,60,20,0,0,0,0,10,60
5,10,10,3055,-10,30,40,10,0,0,0,0,-10,40
5,11,11,2875,-10,50,60,10,0,0,0,0,-10,60
5,12,12,2763,0,60,60,0,0,0,0,,,60
5,13,13,2783,-20,20,40,20,0,0,0,0.5,-10,40
5,14,14,2788,20,80,60,20,0,0,0,0,10,60
5,15,15,2845,10,40,30,10,0,-10,10,0,10,40
5,16,16,2855,10,70,60,10,0,0,0,1,10,60
5,17,17,2815,30,60,30,30,0,-10,10,0.333333333,30,40
5,18,18,2794,-30,40,70,30,0,10,10,0,-30,60
5,19,19,2657,10,50,40,10,0,0,0,0,10,40
5,20,20,2766,10,80,70,10,0,10,10,0,10,60
5,21,21,2656,-30,40,70,30,0,10,10,0,-30,60
5,22,22,2787,-20,20,40,20,0,0,0,0.5,-10,40
5,23,23,2859,0,30,30,0,0,-10,10,,,40
5,24,24,2826,-10,60,70,10,0,10,10,0,-10,60
5,25,25,2667,20,50,30,20,0,-10,10,0,10,40
5,26,26,2745,10,40,30,10,0,-10,10,0,10,40
5,27,27,2628,-20,50,70,20,0,10,10,0,-10,60
5,28,28,2691,0,70,70,0,0,10,10,,,60
5,29,29,2678,30,60,30,30,0,-10,10,,30,40
5,30,0,4276,-50,0,50,50,1,10,10,0.8,-50,40
5,31,1,2937,-30,20,50,30,1,-10,10,0.333333333,-30,60
5,32,2,2736,10,20,10,10,1,-30,30,1,10,40
5,33,3,2846,40,80,40,40,1,-20,20,0.25,50,60
5,34,4,2847,60,80,20,60,1,-20,20,0.166666667,50,40
5,35,5,2966,30,60,30,30,1,-10,10,0.666666667,30,40
5,36,6,2719,-10,40,50,10,1,-10,10,1,-10,60
5,37,7,2745,60,100,40,60,1,-20,20,0.166666667,50,60
5,38,8,2629,-10,40,50,10,1,10,10,0,-10,40
5,39,9,3258,10,60,50,10,1,-10,10,0,10,60
5,40,10,2776,10,60,50,10,1,-10,10,1,10,60
5,41,11,2754,-50,0,50,50,1,10,10,0.4,-50,40
5,42,12,2680,-10,20,30,10,1,-10,10,0,-10,40
5,43,13,2630,-40,20,60,40,1,0,0,0,-50,60
5,44,14,2582,30,60,30,30,1,-10,10,0.333333333,30,40
5,45,15,2740,40,100,60,40,1,0,0,-0.5,50,60
5,46,16,2987,0,40,40,0,1,0,0,,,40
5,47,17,3232,0,40,40,0,1,-20,20,,,60
5,48,18,2890,10,80,70,10,1,10,10,0,10,60
5,49,19,2661,40,80,40,40,1,0,0,0.25,50,40
5,50,20,3301,30,80,50,30,1,10,10,-0.666666667,30,40
5,51,21,2854,-10,60,70,10,1,10,10,0,-10,60
5,52,22,2868,-50,20,70,50,1,10,10,0.4,-50,60
5,53,23,2895,10,40,30,10,1,-10,10,1,10,40
5,54,24,2799,50,100,50,50,1,-10,10,0.4,50,60
5,55,25,2809,-40,0,40,40,1,0,0,0.25,-50,40
5,56,26,3038,-30,40,70,30,1,10,10,0.333333333,-30,60
5,57,27,2959,30,60,30,30,1,-10,10,1.333333333,30,40
5,58,28,2789,-50,20,70,50,1,30,30,,-50,40
5,59,29,2767,20,80,60,20,1,0,0,,10,60
6,0,0,5764,-20,40,60,20,1,20,20,0,-10,40
6,1,1,3639,40,80,40,40,1,-20,20,0.75,50,60
6,2,2,4440,0,60,60,0,1,20,20,,,40
6,3,3,4458,-10,60,70,10,1,10,10,-1,-10,60
6,4,4,4009,40,80,40,40,1,0,0,0.75,50,40
6,5,5,4168,-70,0,70,70,1,30,30,-0.142857143,-70,40
6,6,6,4562,-40,40,80,40,1,20,20,1,-50,60
6,7,7,4361,-20,20,40,20,1,-20,20,0,-10,60
6,8,8,3610,-60,20,80,60,1,40,40,0.5,-50,40
6,9,9,4409,60,100,40,60,1,-20,20,0.5,50,60
6,10,10,3458,-50,20,70,50,1,10,10,1,-50,60
6,11,11,5481,-10,40,50,10,1,10,10,-1,-10,40
6,12,12,4042,0,60,60,0,1,20,20,,,40
6,13,13,3409,60,80,20,60,1,-40,40,0.833333333,50,60
6,14,14,4425,-20,20,40,20,1,0,0,-2,-10,40
6,15,15,3849,-10,60,70,10,1,10,10,0,-10,60
6,16,16,3889,-80,0,80,80,1,40,40,0.75,-70,40
6,17,17,5104,-30,40,70,30,1,10,10,1,-30,60
6,18,18,4465,60,100,40,60,1,-20,20,0,50,60
6,19,19,4450,60,80,20,60,1,-20,20,1,50,40
6,20,20,3233,-60,20,80,60,1,40,40,1,-50,40
6,21,21,3370,20,60,40,20,1,-20,20,1,10,60
6,22,22,3874,20,80,60,20,1,0,0,0,10,60
6,23,23,4457,40,60,20,40,1,-20,20,1,50,40
6,24,24,4201,-40,20,60,40,1,0,0,0.5,-50,60
6,25,25,4994,-20,40,60,20,1,20,20,1.5,-10,40
6,26,26,3624,60,100,40,60,1,-20,20,0.666666667,50,60
6,27,27,4665,50,80,30,50,1,-10,10,0.6,50,40
6,28,28,4586,-60,0,60,60,1,20,20,,-50,40
6,29,29,4201,-40,40,80,40,1,20,20,,-50,60
6,30,0,4385,20,60,40,20,0,-20,20,2,10,60
6,31,1,4338,20,40,20,20,0,-20,20,1,10,40
6,32,2,4473,10,50,40,10,0,0,0,1,10,40
6,33,3,4649,-30,50,80,30,0,20,20,0.666666667,-30,60
6,34,4,3249,10,70,60,10,0,0,0,0,10,60
6,35,5,3601,-30,20,50,30,0,10,10,0.333333333,-30,40
6,36,6,3865,20,60,40,20,0,0,0,0.5,10,40
6,37,7,4209,20,80,60,20,0,0,0,1,10,60
6,38,8,3538,-20,30,50,20,0,10,10,0.5,-10,40
6,39,9,3777,-40,40,80,40,0,20,20,1,-50,60
6,40,10,4081,20,60,40,20,0,0,0,0.5,10,40
6,41,11,4082,20,60,40,20,0,-20,20,1,10,60
6,42,12,3472,10,70,60,10,0,0,0,0,10,60
6,43,13,4419,0,50,50,0,0,10,10,,,40
6,44,14,4312,-20,40,60,20,0,0,0,0.5,-10,60
6,45,15,4384,-20,20,40,20,0,0,0,0,-10,40
6,46,16,4688,0,50,50,0,0,-10,10,,,60
6,47,17,4337,-10,30,40,10,0,0,0,2,-10,40
6,48,18,4681,30,80,50,30,0,-10,10,0.333333333,30,60
6,49,19,3881,20,40,20,20,0,-20,20,1,10,40
6,50,20,3585,10,70,60,10,0,0,0,0,10,60
6,51,21,3656,20,80,60,20,0,0,0,0,10,60
6,52,22,3609,-20,20,40,20,0,0,0,0,-10,40
6,53,23,4321,0,40,40,0,0,0,0,,,40
6,54,24,4289,0,60,60,0,0,0,0,,,60
6,55,25,4392,40,60,20,40,0,-20,20,0,50,40
6,56,26,4146,30,50,20,30,0,-20,20,1,30,40
6,57,27,3617,-30,50,80,30,0,20,20,1,-30,60
6,58,28,5042,-10,40,50,10,0,-10,10,,-10,60
6,59,29,3761,-20,30,50,20,0,10,10,,-10,40
7,0,0,4006,-71,0,71,71,1,31,31,0.38028169,-70,40
7,1,1,4258,25,80,55,25,1,-5,5,-0.2,30,60
7,2,2,4040,36,80,44,36,1,4,4,0.166666667,30,40
7,3,3,4552,50,100,50,50,1,-10,10,0.54,50,60
7,4,4,3889,10,60,50,10,1,10,10,-0.6,10,40
7,5,5,4203,-4,40,44,4,1,4,4,3.5,-10,40
7,6,6,4354,-57,20,77,57,1,17,17,1,-50,60
7,7,7,4639,40,60,20,40,1,-40,40,1,50,60
7,8,8,4410,-10,20,30,10,1,-10,10,-1.2,-10,40
7,9,9,3895,-20,40,60,20,1,0,0,0.75,-10,60
7,10,10,4104,15,60,45,15,1,-15,15,1.333333333,10,60
7,11,11,4206,18,60,42,18,1,2,2,0.722222222,10,40
7,12,12,4244,-55,0,55,55,1,15,15,0.454545455,-50,40
7,13,13,4792,-45,20,65,45,1,5,5,0.022222222,-50,60
7,14,14,4524,10,40,30,10,1,-10,10,2.4,10,40
7,15,15,4328,-24,40,64,24,1,4,4,-0.25,-30,60
7,16,16,5052,26,80,54,26,1,14,14,-0.730769231,30,40
7,17,17,3870,30,100,70,30,1,10,10,-0.333333333,30,60
7,18,18,4025,20,80,60,20,1,0,0,-1,10,60
7,19,19,4645,-15,20,35,15,1,-5,5,0.666666667,-10,40
7,20,20,4057,15,40,25,15,1,-15,15,1.266666667,10,40
7,21,21,4070,60,100,40,60,1,-20,20,0.416666667,50,60
7,22,22,5171,-5,60,65,5,1,5,5,-2.4,-10,60
7,23,23,4100,-44,0,44,44,1,4,4,0.272727273,-50,40
7,24,24,4856,-57,20,77,57,1,17,17,0.649122807,-50,60
7,25,25,4883,-12,20,32,12,1,-8,8,-0.583333333,-10,40
7,26,26,4605,0,40,40,0,1,-20,20,,,60
7,27,27,4380,41,80,39,41,1,-1,1,1.487804878,50,40
7,28,28,4306,-40,60,100,40,1,60,60,,-50,40
7,29,29,3951,25,80,55,25,1,-5,5,,30,60
7,30,0,6621,20,80,60,20,0,0,0,-0.25,10,60
7,31,1,4100,-10,60,70,10,0,30,30,-1,-10,40
7,32,2,4018,-60,20,80,60,0,40,40,0.666666667,-50,40
7,33,3,4152,5,60,55,5,0,-5,5,1,10,60
7,34,4,3747,-10,50,60,10,0,0,0,1,-10,60
7,35,5,4146,-10,30,40,10,0,0,0,0,-10,40
7,36,6,4087,10,50,40,10,0,0,0,-1.5,10,40
7,37,7,3785,20,70,50,20,0,-10,10,0.25,10,60
7,38,8,4155,15,40,25,15,0,-15,15,1.333333333,10,40
7,39,9,4282,-15,40,55,15,0,-5,5,0.666666667,-10,60
7,40,10,5058,-5,40,45,5,0,5,5,-2,-10,40
7,41,11,5578,35,80,45,35,0,-15,15,0.914285714,30,60
7,42,12,4117,-37,40,77,37,0,17,17,0.756756757,-30,60
7,43,13,3676,-25,30,55,25,0,15,15,-0.6,-30,40
7,44,14,4367,21,70,49,21,0,-11,11,-0.428571429,30,60
7,45,15,5340,-50,20,70,50,0,30,30,0.7,-50,40
7,46,16,4368,10,50,40,10,0,-20,20,2,10,60
7,47,17,4098,15,50,35,15,0,-5,5,0.333333333,10,40
7,48,18,4371,0,60,60,0,0,0,0,,,60
7,49,19,3711,20,60,40,20,0,0,0,1.5,10,40
7,50,20,4563,-5,50,55,5,0,-5,5,-2,-10,60
7,51,21,3509,5,70,65,5,0,5,5,2,10,60
7,52,22,4163,-30,40,70,30,0,30,30,0.666666667,-30,40
7,53,23,5298,10,60,50,10,0,10,10,1.5,10,40
7,54,24,3831,5,80,75,5,0,15,15,-7,10,60
7,55,25,5030,-35,30,65,35,0,25,25,1,-30,40
7,56,26,4532,-10,20,30,10,0,-10,10,-3.5,-10,40
7,57,27,4293,20,60,40,20,0,-20,20,1.85,10,60
7,58,28,4286,-37,40,77,37,0,17,17,,-30,60
7,59,29,4393,-15,50,65,15,0,25,25,,-10,40
8,0,0,5366,10,60,50,10,0,-10,10,2,10,60
8,1,1,4961,15,50,35,15,0,-5,5,-1,10,40
8,2,2,4038,20,40,20,20,0,-20,20,1.5,10,40
8,3,3,3667,-20,50,70,20,0,10,10,2.5,-10,60
8,4,4,3620,50,70,20,50,0,-40,40,1.2,50,60
8,5,5,4160,-30,20,50,30,0,10,10,-0.333333333,-30,40
8,6,6,3012,0,60,60,0,0,20,20,,,40
8,7,7,4095,0,80,80,0,0,20,20,,,60
8,8,8,4018,-10,30,40,10,0,0,0,1.5,-10,40
8,9,9,5894,-30,40,70,30,0,10,10,-0.333333333,-30,60
8,10,10,4088,15,40,25,15,0,-15,15,2.333333333,10,40
8,11,11,3763,-20,60,80,20,0,20,20,1,-10,60
8,12,12,3599,-20,40,60,20,0,0,0,0,-10,60
8,13,13,5599,-40,20,60,40,0,20,20,0.5,-50,40
8,14,14,4630,20,80,60,20,0,0,0,0.5,10,60
8,15,15,3977,20,60,40,20,0,0,0,0.25,10,40
8,16,16,3444,0,70,70,0,0,10,10,,,60
8,17,17,3483,5,50,45,5,0,5,5,-7,10,40
8,18,18,5034,-20,50,70,20,0,10,10,0.5,-10,60
8,19,19,4669,20,30,10,20,0,-30,30,0.5,10,40
8,20,20,3679,0,60,60,0,0,0,0,,,60
8,21,21,3392,30,80,50,30,0,-10,10,-0.333333333,30,60
8,22,22,6587,40,60,20,40,0,-20,20,0.25,50,40
8,23,23,4265,-10,20,30,10,0,-10,10,0.5,-10,40
8,24,24,5117,30,70,40,30,0,-20,20,0.666666667,30,60
8,25,25,4036,5,30,25,5,0,-15,15,3,10,40
8,26,26,4818,0,40,40,0,0,0,0,,,40
8,27,27,5173,-20,40,60,20,0,0,0,1.5,-10,60
8,28,28,4189,20,50,30,20,0,-30,30,,10,60
8,29,29,3489,30,50,20,30,0,-20,20,,30,40
8,30,0,3788,-50,20,70,50,1,30,30,0.8,-50,40
8,31,1,3661,10,60,50,10,1,-10,10,2,10,60
8,32,2,3716,-30,0,30,30,1,-10,10,0.333333333,-30,40
8,33,3,3437,30,100,70,30,1,10,10,0,30,60
8,34,4,3525,40,60,20,40,1,-20,20,0.5,50,40
8,35,5,3670,40,80,40,40,1,0,0,0.5,50,40
8,36,6,4580,-50,20,70,50,1,10,10,0.6,-50,60
8,37,7,3728,0,40,40,0,1,-20,20,,,60
8,38,8,4147,-20,40,60,20,1,20,20,0,-10,40
8,39,9,5684,40,80,40,40,1,-20,20,-0.25,50,60
8,40,10,4033,50,80,30,50,1,-30,30,1,50,60
8,41,11,5697,-60,0,60,60,1,20,20,0.333333333,-50,40
8,42,12,5752,20,60,40,20,1,0,0,2,10,40
8,43,13,3624,-60,20,80,60,1,20,20,0.833333333,-50,60
8,44,14,4641,-60,20,80,60,1,40,40,0.166666667,-50,40
8,45,15,3994,30,60,30,30,1,-30,30,0,30,60
8,46,16,3733,10,80,70,10,1,30,30,1,10,40
8,47,17,4256,70,100,30,70,1,-30,30,-0.142857143,70,60
8,48,18,6708,20,40,20,20,1,-40,40,0.5,10,60
8,49,19,4071,-40,40,80,40,1,40,40,0.75,-50,40
8,50,20,3731,10,60,50,10,1,10,10,2,10,40
8,51,21,3759,30,60,30,30,1,-30,30,-0.333333333,30,60
8,52,22,3782,20,40,20,20,1,-40,40,2.5,10,60
8,53,23,3940,-50,20,70,50,1,30,30,0.2,-50,40
8,54,24,3446,-50,20,70,50,1,10,10,0.8,-50,60
8,55,25,3850,20,80,60,20,1,20,20,0.5,10,40
8,56,26,3570,70,100,30,70,1,-30,30,0.571428571,70,60
8,57,27,3767,-70,0,70,70,1,30,30,0.428571429,-70,40
8,58,28,3760,0,40,40,0,1,0,0,,,40
8,59,29,4657,10,80,70,10,1,10,10,,10,60
9,0,0,4093,10,80,70,10,1,30,30,-2,10,40
9,1,1,2975,30,60,30,30,1,-30,30,0,30,60
9,2,2,2898,10,60,50,10,1,10,10,0,10,40
9,3,3,3360,50,80,30,50,1,-30,30,0.8,50,60
9,4,4,2990,-10,40,50,10,1,10,10,0,-10,40
9,5,5,3460,-50,0,50,50,1,10,10,0.8,-50,40
9,6,6,2699,-50,20,70,50,1,10,10,0.8,-50,60
9,7,7,3022,10,40,30,10,1,-30,30,0,10,60
9,8,8,3300,10,20,10,10,1,-30,30,-1,10,40
9,9,9,3097,70,100,30,70,1,-30,30,0.571428571,70,60
9,10,10,3027,-10,60,70,10,1,10,10,1,-10,60
9,11,11,2333,60,60,0,60,1,-40,40,0.333333333,50,40
9,12,12,2909,20,40,20,20,1,-20,20,0,10,40
9,13,13,3140,-20,40,60,20,1,0,0,0.5,-10,60
9,14,14,2815,0,20,20,0,1,-20,20,,,40
9,15,15,2972,30,80,50,30,1,-10,10,-0.333333333,30,60
9,16,16,2574,-70,0,70,70,1,30,30,0.714285714,-70,40
9,17,17,2853,60,100,40,60,1,-20,20,0.666666667,50,60
9,18,18,2512,-60,20,80,60,1,20,20,0,-50,60
9,19,19,2832,60,80,20,60,1,-20,20,0.5,50,40
9,20,20,3426,-10,40,50,10,1,10,10,2,-10,40
9,21,21,2577,-40,40,80,40,1,20,20,0.75,-50,60
9,22,22,2597,10,60,50,10,1,-10,10,0,10,60
9,23,23,2894,-30,0,30,30,1,-10,10,0.333333333,-30,40
9,24,24,2586,-30,20,50,30,1,-10,10,0.666666667,-30,60
9,25,25,2975,40,60,20,40,1,-20,20,0,50,40
9,26,26,2618,70,100,30,70,1,-30,30,0.571428571,70,60
9,27,27,3257,60,80,20,60,1,-20,20,0.833333333,50,40
9,28,28,4181,-50,20,70,50,1,30,30,,-50,40
9,29,29,2582,10,80,70,10,1,10,10,,10,60
9,30,0,4080,20,80,60,20,0,0,0,1,10,60
9,31,1,3096,20,40,20,20,0,-20,20,1,10,40
9,32,2,2994,20,60,40,20,0,0,0,-0.5,10,40
9,33,3,2861,-20,60,80,20,0,20,20,1.5,-10,60
9,34,4,2902,20,70,50,20,0,-10,10,0,10,60
9,35,5,2927,20,50,30,20,0,-10,10,-0.5,10,40
9,36,6,3160,10,30,20,10,0,-20,20,1,10,40
9,37,7,2582,0,50,50,0,0,-10,10,,,60
9,38,8,3393,-10,20,30,10,0,-10,10,0,-10,40
9,39,9,2677,-10,40,50,10,0,-10,10,0,-10,60
9,40,10,3794,20,50,30,20,0,-10,10,-0.5,10,40
9,41,11,2678,-10,40,50,10,0,-10,10,-1,-10,60
9,42,12,2539,-10,50,60,10,0,0,0,-1,-10,60
9,43,13,2944,0,20,20,0,0,-20,20,,,40
9,44,14,3236,-10,60,70,10,0,10,10,1,-10,60
9,45,15,2995,10,30,20,10,0,-20,20,1,10,40
9,46,16,2862,10,70,60,10,0,0,0,1,10,60
9,47,17,2948,30,60,30,30,0,-10,10,0.333333333,30,40
9,48,18,2597,10,80,70,10,0,10,10,-2,10,60
9,49,19,3403,0,40,40,0,0,0,0,,,40
9,50,20,2725,10,60,50,10,0,-10,10,2,10,60
9,51,21,2876,-30,40,70,30,0,10,10,0.333333333,-30,60
9,52,22,3307,0,30,30,0,0,-10,10,,,40
9,53,23,2989,40,40,0,40,0,-40,40,1,50,40
9,54,24,2638,-10,50,60,10,0,0,0,0,-10,60
9,55,25,3384,10,50,40,10,0,0,0,-2,10,40
9,56,26,3140,40,60,20,40,0,-20,20,0,50,40
9,57,27,3388,20,80,60,20,0,0,0,1,10,60
9,58,28,3223,-10,70,80,10,0,20,20,,-10,60
9,59,29,3069,0,20,20,0,0,-20,20,,,40
10,0,0,5496,-40,0,40,40,1,0,0,0.375,-50,40
10,1,1,3220,40,80,40,40,1,-20,20,0.375,50,60
10,2,2,3927,35,60,25,35,1,-15,15,0.571428571,30,40
10,3,3,4502,45,100,55,45,1,-5,5,-0.666666667,50,60
10,4,4,4490,35,80,45,35,1,5,5,0.142857143,30,40
10,5,5,3792,-10,40,50,10,1,10,10,-1.5,-10,40
10,6,6,2994,15,40,25,15,1,-35,35,1.333333333,10,60
10,7,7,4288,15,60,45,15,1,-15,15,2,10,60
10,8,8,4335,-45,20,65,45,1,25,25,0.422222222,-50,40
10,9,9,3517,-55,20,75,55,1,15,15,0.636363636,-50,60
10,10,10,3985,60,100,40,60,1,-20,20,0.583333333,50,60
10,11,11,4463,-6,40,46,6,1,6,6,-1.5,-10,40
10,12,12,2928,-55,0,55,55,1,15,15,0.363636364,-50,40
10,13,13,3831,5,80,75,5,1,15,15,-2,10,60
10,14,14,2947,45,80,35,45,1,-5,5,0.666666667,50,40
10,15,15,3126,-45,20,65,45,1,5,5,1.333333333,-50,60
10,16,16,4072,-45,20,65,45,1,25,25,0.866666667,-50,40
10,17,17,2579,35,40,5,35,1,-55,55,0.428571429,30,60
10,18,18,2864,40,60,20,40,1,-40,40,0.75,50,60
10,19,19,4206,34,60,26,34,1,-14,14,-0.617647059,30,40
10,20,20,2713,75,80,5,75,1,-35,35,0.266666667,70,40
10,21,21,3487,30,80,50,30,1,-10,10,-1.5,30,60
10,22,22,2528,95,100,5,95,1,-55,55,-0.052631579,70,60
10,23,23,10145,-25,0,25,25,1,-15,15,-0.4,-30,40
10,24,24,3297,40,40,0,40,1,-60,60,0.625,50,60
10,25,25,3856,25,60,35,25,1,-5,5,1.6,30,40
10,26,26,7256,35,60,25,35,1,-35,35,1.571428571,30,60
10,27,27,3489,-35,40,75,35,1,35,35,2.142857143,-30,40
10,28,28,2920,20,20,0,20,1,-40,40,,10,40
10,29,29,4328,-60,20,80,60,1,20,20,,-50,60
10,30,0,3900,5,80,75,5,0,15,15,5,10,60
10,31,1,3248,-20,30,50,20,0,10,10,0.75,-10,40
10,32,2,3720,15,50,35,15,0,-5,5,-0.666666667,10,40
10,33,3,4078,-60,40,100,60,0,40,40,0.583333333,-50,60
10,34,4,3400,-15,50,65,15,0,5,5,-0.666666667,-10,60
10,35,5,4063,35,60,25,35,0,-15,15,-0.571428571,30,40
10,36,6,3280,35,40,5,35,0,-35,35,2,30,40
10,37,7,3800,-5,70,75,5,0,15,15,2,-10,60
10,38,8,4712,-55,20,75,55,0,35,35,1.181818182,-50,40
10,39,9,3512,-5,60,65,5,0,5,5,4,-10,60
10,40,10,3761,20,30,10,20,0,-30,30,1.25,10,40
10,41,11,4136,25,70,45,25,0,-15,15,2.2,30,60
10,42,12,3926,-20,80,100,20,0,40,40,1.75,-10,60
10,43,13,4496,25,60,35,25,0,-5,5,-1,30,40
10,44,14,3648,-15,50,65,15,0,5,5,1.333333333,-10,60
10,45,15,3296,40,50,10,40,0,-30,30,0.625,50,40
10,46,16,3785,15,60,45,15,0,-15,15,2.333333333,10,60
10,47,17,3879,-15,20,35,15,0,-5,5,0.666666667,-10,40
10,48,18,3878,-40,40,80,40,0,20,20,0,-50,60
10,49,19,3766,15,40,25,15,0,-15,15,1.333333333,10,40
10,50,20,4320,-40,40,80,40,0,20,20,0.375,-50,60
10,51,21,4934,-15,50,65,15,0,5,5,-1,-10,60
10,52,22,3697,-5,40,45,5,0,5,5,-4,-10,40
10,53,23,3768,-45,20,65,45,0,25,25,0,-50,40
10,54,24,3801,0,80,80,0,0,20,20,,,60
10,55,25,3504,-35,30,65,35,0,25,25,0.285714286,-30,40
10,56,26,4337,-5,50,55,5,0,15,15,1,-10,40
10,57,27,6728,40,70,30,40,0,-30,30,0.25,50,60
10,58,28,3408,20,60,40,20,0,-20,20,,10,60
10,59,29,3032,10,60,50,10,0,10,10,,10,40
11,0,0,5159,-30,40,70,30,0,10,10,0.333333333,-30,60
11,1,1,4984,-45,30,75,45,0,35,35,0.777777778,-50,40
11,2,2,4737,0,40,40,0,0,0,0,,,40
11,3,3,4955,10,70,60,10,0,0,0,1.5,10,60
11,4,4,4623,-15,60,75,15,0,15,15,0.333333333,-10,60
11,5,5,5124,-10,20,30,10,0,-10,10,0.5,-10,40
11,6,6,5306,25,50,25,25,0,-15,15,1,30,40
11,7,7,5675,-20,50,70,20,0,10,10,-0.25,-10,60
11,8,8,4906,10,60,50,10,0,10,10,-1,10,40
11,9,9,4982,5,80,75,5,0,15,15,-2,10,60
11,10,10,4879,20,60,40,20,0,0,0,1,10,40
11,11,11,4757,-15,50,65,15,0,5,5,-0.333333333,-10,60
11,12,12,4998,-10,60,70,10,0,10,10,2,-10,60
11,13,13,5483,-30,30,60,30,0,20,20,0.666666667,-30,40
11,14,14,4756,30,80,50,30,0,-10,10,0.666666667,30,60
11,15,15,4836,-20,20,40,20,0,0,0,0,-10,40
11,16,16,5223,-30,40,70,30,0,10,10,-0.333333333,-30,60
11,17,17,4896,0,40,40,0,0,0,0,,,40
11,18,18,5005,-10,70,80,10,0,20,20,0,-10,60
11,19,19,4487,30,50,20,30,0,-20,20,0,30,40
11,20,20,5539,-20,60,80,20,0,20,20,0.75,-10,60
11,21,21,5754,5,70,65,5,0,5,5,-7,10,60
11,22,22,4401,40,60,20,40,0,-20,20,0.125,50,40
11,23,23,4865,15,40,25,15,0,-15,15,1,10,40
11,24,24,5235,10,40,30,10,0,-30,30,5,10,60
11,25,25,4860,-10,30,40,10,0,0,0,0,-10,40
11,26,26,4635,-20,20,40,20,0,0,0,0,-10,40
11,27,27,5018,-30,50,80,30,0,20,20,0.166666667,-30,60
11,28,28,4618,5,80,75,5,0,15,15,,10,60
11,29,29,5820,10,50,40,10,0,0,0,,10,40
11,30,0,5506,-20,60,80,20,1,40,40,-0.5,-10,40
11,31,1,4763,0,40,40,0,1,-20,20,,,60
11,32,2,4758,-50,40,90,50,1,50,50,1.2,-50,40
11,33,3,4769,10,80,70,10,1,10,10,-1,10,60
11,34,4,4529,50,80,30,50,1,-10,10,0.6,50,40
11,35,5,4994,-60,0,60,60,1,20,20,0.166666667,-50,40
11,36,6,6499,0,60,60,0,1,0,0,,,60
11,37,7,4626,-70,20,90,70,1,30,30,0.428571429,-70,60
11,38,8,4672,-30,20,50,30,1,10,10,0,-30,40
11,39,9,4631,40,100,60,40,1,0,0,0.75,50,60
11,40,10,4515,-70,20,90,70,1,30,30,0,-70,60
11,41,11,4560,-10,40,50,10,1,10,10,0,-10,40
11,42,12,4780,30,80,50,30,1,10,10,-0.666666667,30,40
11,43,13,4631,-10,80,90,10,1,30,30,2,-10,60
11,44,14,6277,30,60,30,30,1,-10,10,0.333333333,30,40
11,45,15,5740,-10,60,70,10,1,10,10,4,-10,60
11,46,16,4802,-20,20,40,20,1,0,0,-1,-10,40
11,47,17,5291,70,100,30,70,1,-30,30,0.428571429,70,60
11,48,18,5477,-20,40,60,20,1,0,0,-1.5,-10,60
11,49,19,4734,-60,0,60,60,1,20,20,0.583333333,-50,40
11,50,20,5421,-5,20,25,5,1,-15,15,-3,-10,40
11,51,21,4682,-10,80,90,10,1,30,30,3,-10,60
11,52,22,5553,-40,20,60,40,1,0,0,-1,-50,60
11,53,23,5505,-40,0,40,40,1,0,0,0.25,-50,40
11,54,24,4863,-40,60,100,40,1,40,40,0.75,-50,60
11,55,25,4484,30,60,30,30,1,-10,10,-0.333333333,30,40
11,56,26,4932,-30,40,70,30,1,10,10,0.333333333,-30,60
11,57,27,4432,60,80,20,60,1,-20,20,0.166666667,50,40
11,58,28,5142,10,40,30,10,1,-10,10,,10,40
11,59,29,4458,40,100,60,40,1,0,0,,50,60
12,0,0,5561,-50,0,50,50,1,10,10,-0.6,-50,40
12,1,1,2755,14,20,6,14,1,-54,54,2.428571429,10,60
12,2,2,4122,0,80,80,0,1,40,40,,,40
12,3,3,3119,0,40,40,0,1,-20,20,,,60
12,4,4,4139,10,60,50,10,1,10,10,-5,10,40
12,5,5,2279,40,40,0,40,1,-40,40,1,50,40
12,6,6,7005,,80,,,1,,,,,60
12,7,7,7028,,60,,,1,,,,,60
12,8,8,5606,-20,20,40,20,1,0,0,-0.5,-10,40
12,9,9,5591,80,100,20,80,1,-40,40,0.625,70,60
12,10,10,3131,-10,60,70,10,1,10,10,-2,-10,60
12,11,11,3237,10,60,50,10,1,10,10,-3,10,40
12,12,12,3249,60,80,20,60,1,-20,20,1.166666667,50,40
12,13,13,3215,10,100,90,10,1,30,30,-2,10,60
12,14,14,2817,-70,20,90,70,1,50,50,-0.142857143,-70,40
12,15,15,5082,-30,40,70,30,1,10,10,1,-30,60
12,16,16,3659,-100,0,100,100,1,60,60,0.5,-70,40
12,17,17,4994,-20,20,40,20,1,-20,20,1.8,-10,60
12,18,18,4050,76,80,4,76,1,-56,56,0.736842105,70,60
12,19,19,3321,-10,40,50,10,1,10,10,-3,-10,40
12,20,20,3567,-20,60,80,20,1,40,40,0.5,-10,40
12,21,21,3307,-20,40,60,20,1,0,0,1,-10,60
12,22,22,3493,40,80,40,40,1,-20,20,1.25,50,60
12,23,23,3436,-30,40,70,30,1,30,30,-0.333333333,-30,40
12,24,24,3305,-30,60,90,30,1,30,30,3,-30,60
12,25,25,3085,-80,0,80,80,1,40,40,0.5,-70,40
12,26,26,2493,100,100,0,100,1,-60,60,0.2,70,60
12,27,27,3249,-20,20,40,20,1,0,0,0.5,-10,40
12,28,28,3296,50,80,30,50,1,-10,10,,50,40
12,29,29,3491,0,20,20,0,1,-40,40,,,60
12,30,0,3947,50,70,20,50,0,-40,40,0.8,50,60
12,31,1,4143,35,50,15,35,0,-25,25,1.857142857,30,40
12,32,2,2884,-50,30,80,50,0,40,40,0.8,-50,40
12,33,3,3249,-10,50,60,10,0,0,0,2,-10,60
12,34,4,4020,40,80,40,40,0,-20,20,-0.75,50,60
12,35,5,3449,20,60,40,20,0,0,0,-2,10,40
12,36,6,2603,40,40,0,40,0,-40,40,1.25,50,40
12,37,7,3015,50,60,10,50,0,-50,50,0,50,60
12,38,8,3217,-30,20,50,30,0,10,10,0,-30,40
12,39,9,2887,30,40,10,30,0,-50,50,1.666666667,30,60
12,40,10,4094,-30,20,50,30,0,10,10,0,-30,40
12,41,11,3413,0,60,60,0,0,0,0,,,60
12,42,12,4355,20,40,20,20,0,-40,40,3,10,60
12,43,13,4978,0,50,50,0,0,10,10,,,40
12,44,14,3446,0,80,80,0,0,20,20,,,60
12,45,15,3195,-30,30,60,30,0,20,20,0.333333333,-30,40
12,46,16,3380,0,50,50,0,0,-10,10,,,60
12,47,17,3356,10,60,50,10,0,10,10,-3,10,40
12,48,18,4997,20,70,50,20,0,-10,10,0.5,10,60
12,49,19,3451,20,40,20,20,0,-20,20,4,10,40
12,50,20,3321,20,80,60,20,0,0,0,1.5,10,60
12,51,21,3560,-40,50,90,40,0,30,30,0.75,-50,60
12,52,22,3391,-70,30,100,70,0,60,60,0.857142857,-70,40
12,53,23,3616,0,40,40,0,0,0,0,,,40
12,54,24,3655,-20,40,60,20,0,0,0,0,-10,60
12,55,25,4156,0,50,50,0,0,10,10,,,40
12,56,26,3878,10,60,50,10,0,10,10,-1,10,40
12,57,27,4444,0,60,60,0,0,0,0,,,60
12,58,28,3967,-10,70,80,10,0,20,20,,-10,60
12,59,29,4769,-20,20,40,20,0,0,0,,-10,40
13,0,0,3617,30,80,50,30,1,10,10,0.833333333,30,40
13,1,1,3783,0,40,40,0,1,-20,20,,,60
13,2,2,2794,-75,0,75,75,1,35,35,0.133333333,-70,40
13,3,3,3674,30,60,30,30,1,-30,30,0.666666667,30,60
13,4,4,4706,-5,60,65,5,1,25,25,0,-10,40
13,5,5,5965,-45,20,65,45,1,25,25,0.777777778,-50,40
13,6,6,4015,-30,20,50,30,1,-10,10,0.666666667,-30,60
13,7,7,4671,70,100,30,70,1,-30,30,-0.071428571,70,60
13,8,8,3887,10,40,30,10,1,-10,10,-0.5,10,40
13,9,9,3897,55,80,25,55,1,-35,35,-0.090909091,50,60
13,10,10,4178,0,20,20,0,1,-40,40,,,60
13,11,11,7026,15,40,25,15,1,-15,15,0.333333333,10,40
13,12,12,3456,-10,20,30,10,1,-10,10,-4.5,-10,40
13,13,13,4590,30,60,30,30,1,-30,30,0.666666667,30,60
13,14,14,3758,-15,60,75,15,1,35,35,0,-10,40
13,15,15,4581,30,80,50,30,1,-10,10,-0.5,30,60
13,16,16,3604,5,80,75,5,1,35,35,-8,10,40
13,17,17,6061,5,40,35,5,1,-25,25,-2,10,60
13,18,18,6120,75,100,25,75,1,-35,35,0,70,60
13,19,19,6014,-35,0,35,35,1,-5,5,-0.428571429,-30,40
13,20,20,4343,-10,40,50,10,1,10,10,0,-10,40
13,21,21,3818,-5,20,25,5,1,-35,35,0,-10,60
13,22,22,3473,15,40,25,15,1,-35,35,0.666666667,10,60
13,23,23,4166,-50,0,50,50,1,10,10,0.5,-50,40
13,24,24,5225,65,100,35,65,1,-25,25,0,70,60
13,25,25,3938,55,80,25,55,1,-15,15,0.818181818,50,40
13,26,26,3623,45,80,35,45,1,-25,25,-0.333333333,50,60
13,27,27,4173,-10,60,70,10,1,30,30,0.5,-10,40
13,28,28,3392,-45,20,65,45,1,25,25,,-50,40
13,29,29,4151,40,60,20,40,1,-40,40,,50,60
13,30,0,4009,25,50,25,25,0,-35,35,-0.2,30,60
13,31,1,2723,-10,20,30,10,0,-10,10,-2,-10,40
13,32,2,3725,-20,30,50,20,0,10,10,1.25,-10,40
13,33,3,2646,60,80,20,60,0,-40,40,1.166666667,50,60
13,34,4,2834,-30,60,90,30,0,30,30,0.5,-30,60
13,35,5,2701,15,40,25,15,0,-15,15,0.666666667,10,40
13,36,6,2885,15,50,35,15,0,-5,5,-0.333333333,10,40
13,37,7,3731,-5,70,75,5,0,15,15,6,-10,60
13,38,8,4179,30,60,30,30,0,-10,10,-0.166666667,30,40
13,39,9,3519,-5,40,45,5,0,-15,15,0,-10,60
13,40,10,4374,-5,20,25,5,0,-15,15,0,-10,40
13,41,11,3910,15,60,45,15,0,-15,15,2,10,60
13,42,12,3666,5,80,75,5,0,15,15,-8,10,60
13,43,13,3947,15,40,25,15,0,-15,15,1,10,40
13,44,14,3406,5,40,35,5,0,-25,25,9,10,60
13,45,15,4340,10,50,40,10,0,0,0,-2,10,40
13,46,16,3388,-10,70,80,10,0,20,20,0.5,-10,60
13,47,17,3474,40,60,20,40,0,-20,20,0.375,50,40
13,48,18,4343,-25,50,75,25,0,15,15,-0.2,-30,60
13,49,19,3679,-5,30,35,5,0,-5,5,0,-10,40
13,50,20,3840,0,80,80,0,0,20,20,,,60
13,51,21,4051,-25,50,75,25,0,15,15,1.6,-30,60
13,52,22,4343,5,40,35,5,0,-5,5,-2,10,40
13,53,23,4673,5,30,25,5,0,-15,15,0,10,40
13,54,24,4510,25,60,35,25,0,-25,25,1.6,30,60
13,55,25,6327,-5,20,25,5,0,-15,15,-2,-10,40
13,56,26,4598,25,60,35,25,0,-5,5,0,30,40
13,57,27,3815,-35,40,75,35,0,15,15,-0.142857143,-30,60
13,58,28,4313,-10,70,80,10,0,20,20,,-10,60
13,59,29,4217,15,50,35,15,0,-5,5,,10,40
14,0,0,3982,30,80,50,30,1,10,10,1.333333333,30,40
14,1,1,3478,0,40,40,0,1,-20,20,,,60
14,2,2,3223,-30,60,90,30,1,50,50,0.433333333,-30,40
14,3,3,3119,30,60,30,30,1,-30,30,1.333333333,30,60
14,4,4,3568,-77,0,77,77,1,37,37,0.090909091,-70,40
14,5,5,2816,-30,40,70,30,1,30,30,0.166666667,-30,40
14,6,6,2745,-50,20,70,50,1,10,10,0.74,-50,60
14,7,7,3223,67,100,33,67,1,-27,27,0.104477612,70,60
14,8,8,4266,-45,20,65,45,1,25,25,0.333333333,-50,40
14,9,9,3553,40,80,40,40,1,-20,20,0.25,50,60
14,10,10,3094,50,100,50,50,1,-10,10,0.1,50,60
14,11,11,2923,10,60,50,10,1,10,10,-1,10,40
14,12,12,3162,-40,0,40,40,1,0,0,0.25,-50,40
14,13,13,3197,-15,40,55,15,1,-5,5,2.2,-10,60
14,14,14,3908,10,40,30,10,1,-10,10,0,10,40
14,15,15,3008,-2,20,22,2,1,-38,38,-14,-10,60
14,16,16,3179,50,80,30,50,1,-10,10,0.2,50,40
14,17,17,3066,10,60,50,10,1,-10,10,2,10,60
14,18,18,3823,10,80,70,10,1,10,10,0,10,60
14,19,19,3225,-20,20,40,20,1,0,0,0.35,-10,40
14,20,20,3174,7,40,33,7,1,-7,7,2.428571429,10,40
14,21,21,3309,30,100,70,30,1,10,10,-0.133333333,30,60
14,22,22,3988,-26,40,66,26,1,6,6,-0.730769231,-30,60
14,23,23,3383,-30,20,50,30,1,10,10,0.2,-30,40
14,24,24,2746,-25,60,85,25,1,25,25,0.96,-30,60
14,25,25,2721,36,80,44,36,1,4,4,0.166666667,30,40
14,26,26,3170,19,80,61,19,1,1,1,1,10,60
14,27,27,2906,10,60,50,10,1,10,10,-1,10,40
14,28,28,3143,-40,0,40,40,1,0,0,,-50,40
14,29,29,2864,-60,20,80,60,1,20,20,,-50,60
14,30,0,3204,30,80,50,30,0,-10,10,1,30,60
14,31,1,2936,10,50,40,10,0,0,0,1.5,10,40
14,32,2,3727,-15,40,55,15,0,15,15,0,-10,40
14,33,3,3509,-40,40,80,40,0,20,20,0.25,-50,60
14,34,4,3260,-10,60,70,10,0,10,10,-1.8,-10,60
14,35,5,2968,-35,20,55,35,0,15,15,0.714285714,-30,40
14,36,6,2791,30,60,30,30,0,-10,10,1,30,40
14,37,7,2862,-18,70,88,18,0,28,28,-0.111111111,-10,60
14,38,8,3744,-30,30,60,30,0,20,20,0.666666667,-30,40
14,39,9,3517,-40,50,90,40,0,30,30,-0.125,-50,60
14,40,10,3097,10,50,40,10,0,0,0,1,10,40
14,41,11,3302,-55,40,95,55,0,35,35,0.127272727,-50,60
14,42,12,3033,-38,50,88,38,0,28,28,0.473684211,-30,60
14,43,13,3096,-20,30,50,20,0,10,10,0.85,-10,40
14,44,14,2927,-10,60,70,10,0,10,10,-1,-10,60
14,45,15,3772,27,60,33,27,0,-7,7,0.407407407,30,40
14,46,16,3320,-10,70,80,10,0,20,20,3,-10,60
14,47,17,3248,-24,20,44,24,0,4,4,0.166666667,-30,40
14,48,18,2849,30,80,50,30,0,-10,10,0.9,30,60
14,49,19,3610,0,40,40,0,0,0,0,,,40
14,50,20,3046,-7,70,77,7,0,17,17,-0.428571429,-10,60
14,51,21,2787,-30,50,80,30,0,20,20,0,-30,60
14,52,22,2861,10,60,50,10,0,10,10,-1.7,10,40
14,53,23,3013,17,50,33,17,0,-7,7,0.705882353,10,40
14,54,24,2746,-20,60,80,20,0,20,20,-0.5,-10,60
14,55,25,3127,-15,30,45,15,0,5,5,0.066666667,-10,40
14,56,26,3807,-4,40,44,4,0,4,4,1,-10,40
14,57,27,3450,-50,40,90,50,0,30,30,0.2,-50,60
14,58,28,2784,0,80,80,0,0,20,20,,,60
14,59,29,3540,-20,20,40,20,0,0,0,,-10,40
15,0,0,3706,-50,40,90,50,0,30,30,1.2,-50,60
15,1,1,4227,-20,30,50,20,0,10,10,0.5,-10,40
15,2,2,3028,10,50,40,10,0,0,0,0,10,40
15,3,3,3058,50,80,30,50,0,-30,30,0.8,50,60
15,4,4,3290,-10,60,70,10,0,10,10,-1,-10,60
15,5,5,3226,0,40,40,0,0,0,0,,,40
15,6,6,3239,10,60,50,10,0,10,10,1,10,40
15,7,7,3028,-30,50,80,30,0,20,20,0.5,-30,60
15,8,8,3028,-40,20,60,40,0,20,20,0.75,-50,40
15,9,9,3206,5,70,65,5,0,5,5,3,10,60
15,10,10,2800,10,40,30,10,0,-10,10,0,10,40
15,11,11,3202,-40,40,80,40,0,20,20,0.25,-50,60
15,12,12,3165,0,70,70,0,0,10,10,,,60
15,13,13,3289,-10,20,30,10,0,-10,10,0,-10,40
15,14,14,3003,-20,60,80,20,0,20,20,0.5,-10,60
15,15,15,3033,0,30,30,0,0,-10,10,,,40
15,16,16,4359,-20,50,70,20,0,10,10,1,-10,60
15,17,17,2896,30,60,30,30,0,-10,10,1,30,40
15,18,18,3238,30,80,50,30,0,-10,10,0.666666667,30,60
15,19,19,3203,-10,50,60,10,0,20,20,3,-10,40
15,20,20,3523,-10,60,70,10,0,10,10,-1,-10,60
15,21,21,3209,-40,40,80,40,0,20,20,0.5,-50,60
15,22,22,3926,20,50,30,20,0,-10,10,2,10,40
15,23,23,3405,-10,60,70,10,0,30,30,0,-10,40
15,24,24,3557,-10,50,60,10,0,0,0,0,-10,60
15,25,25,3134,-30,40,70,30,0,30,30,1,-30,40
15,26,26,3462,-10,30,40,10,0,0,0,0,-10,40
15,27,27,2968,20,80,60,20,0,0,0,-0.5,10,60
15,28,28,4976,20,70,50,20,0,-10,10,,10,60
15,29,29,2793,-20,20,40,20,0,0,0,,-10,40
15,30,0,3487,-20,40,60,20,1,20,20,0,-10,40
15,31,1,3655,-50,20,70,50,1,10,10,0.6,-50,60
15,32,2,2980,20,80,60,20,1,20,20,0.5,10,40
15,33,3,2933,60,100,40,60,1,-20,20,0.5,50,60
15,34,4,4243,-50,20,70,50,1,30,30,0.2,-50,40
15,35,5,3202,0,60,60,0,1,20,20,,,40
15,36,6,3168,-30,40,70,30,1,10,10,0.333333333,-30,60
15,37,7,3671,0,60,60,0,1,0,0,,,60
15,38,8,4363,-70,0,70,70,1,30,30,0.428571429,-70,40
15,39,9,3621,10,80,70,10,1,10,10,0,10,60
15,40,10,2895,30,100,70,30,1,10,10,0,30,60
15,41,11,2940,0,40,40,0,1,0,0,,,40
15,42,12,3311,-10,20,30,10,1,-10,10,-1,-10,40
15,43,13,3458,-30,40,70,30,1,10,10,0.333333333,-30,60
15,44,14,3078,-40,0,40,40,1,0,0,0.5,-50,40
15,45,15,2924,0,60,60,0,1,0,0,,,60
15,46,16,2742,40,60,20,40,1,-20,20,-0.5,50,40
15,47,17,2897,-10,80,90,10,1,30,30,-1,-10,60
15,48,18,3390,-80,20,100,80,1,40,40,0.375,-70,60
15,49,19,2751,80,80,0,80,1,-40,40,0.75,70,40
15,50,20,2753,-40,20,60,40,1,20,20,0.75,-50,40
15,51,21,3711,10,80,70,10,1,10,10,-5,10,60
15,52,22,3360,0,20,20,0,1,-40,40,,,60
15,53,23,3794,50,80,30,50,1,-10,10,-0.2,50,40
15,54,24,3236,40,100,60,40,1,0,0,-0.25,50,60
15,55,25,3313,20,40,20,20,1,-20,20,0,10,40
15,56,26,5092,10,60,50,10,1,-10,10,3,10,60
15,57,27,3899,-20,0,20,20,1,-20,20,-0.5,-10,40
15,58,28,2986,30,60,30,30,1,-10,10,,30,40
15,59,29,3092,-40,40,80,40,1,20,20,,-50,60
16,0,0,7005,-10,50,60,10,0,0,0,-3,-10,60
16,1,1,7004,30,50,20,30,0,-20,20,0.666666667,30,40
16,2,2,7005,-10,30,40,10,0,0,0,1,-10,40
16,3,3,7002,-10,80,90,10,0,30,30,2,-10,60
16,4,4,7001,-10,60,70,10,0,10,10,1,-10,60
16,5,5,7005,30,60,30,30,0,-10,10,0.333333333,30,40
16,6,6,7002,-20,20,40,20,0,0,0,0,-10,40
16,7,7,7002,-20,40,60,20,0,0,0,-1,-10,60
16,8,8,7003,0,40,40,0,0,0,0,,,40
16,9,9,7002,-10,70,80,10,0,20,20,4,-10,60
16,10,10,7001,0,60,60,0,0,20,20,,,40
16,11,11,7003,0,40,40,0,0,-20,20,,,60
16,12,12,7001,0,70,70,0,0,10,10,,,60
16,13,13,7002,10,30,20,10,0,-20,20,1,10,40
16,14,14,7002,-40,50,90,40,0,30,30,0.5,-50,60
16,15,15,7002,20,50,30,20,0,-10,10,1,10,40
16,16,16,7002,10,80,70,10,0,10,10,0,10,60
16,17,17,7004,-10,40,50,10,0,10,10,1,-10,40
16,18,18,7002,-10,60,70,10,0,10,10,0,-10,60
16,19,19,7002,-20,20,40,20,0,0,0,1,-10,40
16,20,20,7005,10,80,70,10,0,10,10,-3,10,60
16,21,21,7004,20,60,40,20,0,-20,20,0,10,60
16,22,22,7001,20,40,20,20,0,-20,20,1,10,40
16,23,23,7003,10,50,40,10,0,0,0,-1,10,40
16,24,24,7002,10,50,40,10,0,-20,20,2,10,60
16,25,25,7002,30,60,30,30,0,-10,10,0.666666667,30,40
16,26,26,7002,-30,20,50,30,0,10,10,0.333333333,-30,40
16,27,27,7002,-20,40,60,20,0,0,0,1,-10,60
16,28,28,7003,30,70,40,30,0,-20,20,,30,60
16,29,29,7003,-10,30,40,10,0,0,0,,-10,40
16,30,0,7001,-60,20,80,60,1,40,40,0.833333333,-50,40
16,31,1,7002,-50,20,70,50,1,10,10,1,-50,60
16,32,2,7002,10,40,30,10,1,-10,10,1,10,40
16,33,3,7005,40,60,20,40,1,-40,40,0.25,50,60
16,34,4,7004,40,80,40,40,1,0,0,0.25,50,40
16,35,5,7004,-50,0,50,50,1,10,10,0.8,-50,40
16,36,6,7005,70,100,30,70,1,-30,30,-0.142857143,70,60
16,37,7,7004,60,80,20,60,1,-40,40,0.166666667,50,60
16,38,8,7001,50,60,10,50,1,-30,30,1.2,50,40
16,39,9,7004,10,40,30,10,1,-30,30,3,10,60
16,40,10,7008,40,100,60,40,1,0,0,0.5,50,60
16,41,11,7003,-70,0,70,70,1,30,30,0.285714286,-70,40
16,42,12,7005,-10,40,50,10,1,10,10,5,-10,40
16,43,13,7002,-40,40,80,40,1,20,20,0.25,-50,60
16,44,14,7005,20,20,0,20,1,-40,40,0,10,40
16,45,15,7004,10,80,70,10,1,10,10,1,10,60
16,46,16,7003,60,60,0,60,1,-40,40,1.166666667,50,40
16,47,17,7005,-60,20,80,60,1,20,20,0,-50,60
16,48,18,7004,-20,60,80,20,1,20,20,2.5,-10,60
16,49,19,7001,10,80,70,10,1,30,30,-6,10,40
16,50,20,7005,30,40,10,30,1,-30,30,0.666666667,30,40
16,51,21,7005,10,40,30,10,1,-30,30,-1,10,60
16,52,22,7003,40,60,20,40,1,-40,40,0,50,60
16,53,23,7005,30,60,30,30,1,-10,10,1.333333333,30,40
16,54,24,7004,60,80,20,60,1,-40,40,0.666666667,50,60
16,55,25,7007,-70,0,70,70,1,30,30,0.285714286,-70,40
16,56,26,7002,-40,20,60,40,1,0,0,0.25,-50,60
16,57,27,7001,-30,20,50,30,1,10,10,-0.666666667,-30,40
16,58,28,7002,10,80,70,10,1,30,30,,10,40
16,59,29,7003,50,100,50,50,1,-10,10,,50,60
17,0,0,7001,,40,,,0,,,,,60
17,1,1,3358,-10,40,50,10,0,10,10,-1,-10,40
17,2,2,3475,-10,50,60,10,0,20,20,-2,-10,40
17,3,3,2712,40,80,40,40,0,-20,20,0.25,50,60
17,4,4,2725,0,50,50,0,0,-10,10,,,60
17,5,5,5387,-50,30,80,50,0,40,40,0.8,-50,40
17,6,6,2657,-20,20,40,20,0,0,0,0,-10,40
17,7,7,3767,45,70,25,45,0,-35,35,0.777777778,50,60
17,8,8,3464,20,60,40,20,0,0,0,0,10,40
17,9,9,2623,0,60,60,0,0,0,0,,,60
17,10,10,2765,0,40,40,0,0,0,0,,,40
17,11,11,2565,-10,50,60,10,0,0,0,2,-10,60
17,12,12,4401,0,40,40,0,0,-20,20,,,60
17,13,13,3841,10,60,50,10,0,10,10,-0.5,10,40
17,14,14,2881,10,70,60,10,0,0,0,0,10,60
17,15,15,3061,5,50,45,5,0,5,5,-1,10,40
17,16,16,2890,0,60,60,0,0,0,0,,,60
17,17,17,3515,-20,20,40,20,0,0,0,0.25,-10,40
17,18,18,4311,20,80,60,20,0,0,0,0.5,10,60
17,19,19,3043,-5,30,35,5,0,-5,5,-4,-10,40
17,20,20,3238,-20,50,70,20,0,10,10,0,-10,60
17,21,21,2876,-10,60,70,10,0,10,10,-0.5,-10,60
17,22,22,3101,-5,50,55,5,0,15,15,3,-10,40
17,23,23,3151,-10,30,40,10,0,0,0,-2.5,-10,40
17,24,24,2904,5,80,75,5,0,15,15,-5,10,60
17,25,25,2958,-5,60,65,5,0,25,25,4,-10,40
17,26,26,3149,-25,20,45,25,0,5,5,0.2,-30,40
17,27,27,2886,-10,40,50,10,0,-10,10,-0.5,-10,60
17,28,28,3134,15,70,55,15,0,-5,5,,10,60
17,29,29,2889,0,40,40,0,0,0,0,,,40
17,30,0,2913,-20,20,40,20,1,0,0,-0.5,-10,40
17,31,1,2716,20,60,40,20,1,-20,20,0,10,60
17,32,2,2725,30,80,50,30,1,10,10,0.333333333,30,40
17,33,3,3117,60,100,40,60,1,-20,20,-0.166666667,50,60
17,34,4,2860,0,60,60,0,1,20,20,,,40
17,35,5,2685,-70,0,70,70,1,30,30,0.428571429,-70,40
17,36,6,2767,10,40,30,10,1,-30,30,-0.5,10,60
17,37,7,2844,55,80,25,55,1,-35,35,0.636363636,50,60
17,38,8,2724,0,40,40,0,1,0,0,,,40
17,39,9,3293,-40,20,60,40,1,0,0,0.25,-50,60
17,40,10,2670,10,60,50,10,1,-10,10,0,10,60
17,41,11,3080,20,60,40,20,1,0,0,0,10,40
17,42,12,3631,-20,20,40,20,1,0,0,0.5,-10,40
17,43,13,3047,30,80,50,30,1,-10,10,-0.333333333,30,60
17,44,14,3782,-30,0,30,30,1,-10,10,0.333333333,-30,40
17,45,15,2750,0,40,40,0,1,-20,20,,,60
17,46,16,3095,60,80,20,60,1,-20,20,0.166666667,50,40
17,47,17,2878,-30,20,50,30,1,-10,10,0.333333333,-30,60
17,48,18,2801,60,100,40,60,1,-20,20,0.166666667,50,60
17,49,19,2723,10,40,30,10,1,-10,10,1,10,40
17,50,20,3082,40,80,40,40,1,0,0,-0.25,50,40
17,51,21,3553,10,60,50,10,1,-10,10,0,10,60
17,52,22,2640,50,100,50,50,1,-10,10,-0.6,50,60
17,53,23,2551,-30,0,30,30,1,-10,10,0,-30,40
17,54,24,2761,60,80,20,60,1,-40,40,0.5,50,60
17,55,25,3188,30,60,30,30,1,-10,10,0.333333333,30,40
17,56,26,2647,-30,20,50,30,1,-10,10,-0.333333333,-30,60
17,57,27,3508,-20,20,40,20,1,0,0,1,-10,40
17,58,28,2901,20,40,20,20,1,-20,20,,10,40
17,59,29,3667,-20,40,60,20,1,0,0,,-10,60
18,0,0,3627,30,40,10,30,0,-50,50,0,30,60
18,1,1,4267,50,60,10,50,0,-30,30,1.2,50,40
18,2,2,4543,-40,30,70,40,0,30,30,0.925,-50,40
18,3,3,3765,50,60,10,50,0,-50,50,1.4,50,60
18,4,4,3008,0,80,80,0,0,20,20,,,60
18,5,5,3196,17,50,33,17,0,-7,7,-0.647058824,10,40
18,6,6,3113,-2,20,22,2,0,-18,18,-4,-10,40
18,7,7,3497,10,70,60,10,0,0,0,0,10,60
18,8,8,3579,10,40,30,10,0,-10,10,0,10,40
18,9,9,3684,-10,50,60,10,0,0,0,0,-10,60
18,10,10,4158,20,50,30,20,0,-10,10,1,10,40
18,11,11,3681,10,70,60,10,0,0,0,1,10,60
18,12,12,3519,-20,50,70,20,0,10,10,0.5,-10,60
18,13,13,3316,10,60,50,10,0,10,10,0,10,40
18,14,14,3544,0,60,60,0,0,0,0,,,60
18,15,15,2859,-20,30,50,20,0,10,10,0,-10,40
18,16,16,3653,-30,40,70,30,0,10,10,0.666666667,-30,60
18,17,17,3232,-10,40,50,10,0,10,10,0,-10,40
18,18,18,2793,30,80,50,30,0,-10,10,0.333333333,30,60
18,19,19,2702,-30,20,50,30,0,10,10,0.666666667,-30,40
18,20,20,2593,10,70,60,10,0,0,0,1,10,60
18,21,21,2870,-30,40,70,30,0,10,10,0,-30,60
18,22,22,2969,10,40,30,10,0,-10,10,1,10,40
18,23,23,2917,20,60,40,20,0,0,0,-0.5,10,40
18,24,24,2681,10,80,70,10,0,10,10,0,10,60
18,25,25,2803,0,30,30,0,0,-10,10,,,40
18,26,26,3506,-10,50,60,10,0,20,20,3,-10,40
18,27,27,2742,-10,60,70,10,0,10,10,1,-10,60
18,28,28,3621,-10,50,60,10,0,0,0,,-10,60
18,29,29,2918,-10,20,30,10,0,-10,10,,-10,40
18,30,0,3212,10,20,10,10,1,-30,30,2,10,40
18,31,1,3098,-40,20,60,40,1,0,0,1,-50,60
18,32,2,3768,30,60,30,30,1,-10,10,0.666666667,30,40
18,33,3,2972,60,80,20,60,1,-40,40,0.666666667,50,60
18,34,4,3092,-50,0,50,50,1,10,10,0.4,-50,40
18,35,5,2908,10,40,30,10,1,-10,10,0,10,40
18,36,6,2672,40,100,60,40,1,0,0,0.25,50,60
18,37,7,2954,-10,60,70,10,1,10,10,0,-10,60
18,38,8,3172,50,80,30,50,1,-10,10,0.6,50,40
18,39,9,3171,-30,40,70,30,1,10,10,0.666666667,-30,60
18,40,10,3419,50,100,50,50,1,-10,10,0.6,50,60
18,41,11,3119,-20,40,60,20,1,20,20,-0.5,-10,40
18,42,12,3567,-10,60,70,10,1,30,30,1,-10,40
18,43,13,2941,0,80,80,0,1,20,20,,,60
18,44,14,3127,-40,20,60,40,1,20,20,0.5,-50,40
18,45,15,3480,-30,40,70,30,1,10,10,2.333333333,-30,60
18,46,16,3210,40,80,40,40,1,0,0,-0.25,50,40
18,47,17,3645,20,20,0,20,1,-60,60,2.5,10,60
18,48,18,3620,10,60,50,10,1,-10,10,1,10,60
18,49,19,2696,-30,0,30,30,1,-10,10,-0.333333333,-30,40
18,50,20,3169,-40,0,40,40,1,0,0,0,-50,40
18,51,21,3007,-20,40,60,20,1,0,0,-0.5,-10,60
18,52,22,3104,10,80,70,10,1,10,10,-1,10,60
18,53,23,3214,0,40,40,0,1,0,0,,,40
18,54,24,2644,-40,20,60,40,1,0,0,0,-50,60
18,55,25,3003,40,80,40,40,1,0,0,0,50,40
18,56,26,3546,0,60,60,0,1,0,0,,,60
18,57,27,2692,-20,20,40,20,1,0,0,0.5,-10,40
18,58,28,2853,30,60,30,30,1,-10,10,,30,40
18,59,29,3818,,100,,,1,,,,,60
19,0,0,3418,-10,70,80,10,0,20,20,3,-10,60
19,1,1,4425,35,60,25,35,0,-15,15,0.571428571,30,40
19,2,2,4304,5,50,45,5,0,5,5,1,10,40
19,3,3,5761,30,80,50,30,0,-10,10,1,30,60
19,4,4,2889,-40,40,80,40,0,20,20,0.125,-50,60
19,5,5,2433,-20,30,50,20,0,10,10,-0.5,-10,40
19,6,6,2706,-20,40,60,20,0,20,20,0.25,-10,40
19,7,7,2659,-15,60,75,15,0,15,15,1,-10,60
19,8,8,2634,-35,20,55,35,0,15,15,0.285714286,-30,40
19,9,9,5538,-10,50,60,10,0,0,0,0.5,-10,60
19,10,10,2449,5,50,45,5,0,5,5,1,10,40
19,11,11,2897,25,80,55,25,0,-5,5,1.4,30,60
19,12,12,3017,-20,70,90,20,0,30,30,0.75,-10,60
19,13,13,4377,10,60,50,10,0,10,10,0,10,40
19,14,14,3144,-25,50,75,25,0,15,15,-0.8,-30,60
19,15,15,2904,-10,40,50,10,0,10,10,0,-10,40
19,16,16,2681,-35,60,95,35,0,35,35,0.428571429,-30,60
19,17,17,2822,-20,30,50,20,0,10,10,0,-10,40
19,18,18,2529,-40,40,80,40,0,20,20,1,-50,60
19,19,19,3489,-30,20,50,30,0,10,10,0,-30,40
19,20,20,2665,30,70,40,30,0,-20,20,0.833333333,30,60
19,21,21,2681,15,80,65,15,0,5,5,-0.666666667,10,60
19,22,22,2713,0,50,50,0,0,10,10,,,40
19,23,23,2745,-15,40,55,15,0,15,15,3.333333333,-10,40
19,24,24,3521,-5,50,55,5,0,-5,5,-3,-10,60
19,25,25,3073,15,20,5,15,0,-35,35,2.333333333,10,40
19,26,26,3921,-10,30,40,10,0,0,0,-1,-10,40
19,27,27,2800,-10,60,70,10,0,10,10,-1,-10,60
19,28,28,2801,-40,40,80,40,0,20,20,,-50,60
19,29,29,2977,10,60,50,10,0,10,10,,10,40
19,30,0,2738,-25,60,85,25,1,45,45,1.8,-30,40
19,31,1,3626,-10,40,50,10,1,-10,10,-0.5,-10,60
19,32,2,2769,-20,20,40,20,1,0,0,1,-10,40
19,33,3,2577,25,80,55,25,1,-5,5,-0.6,30,60
19,34,4,2480,20,40,20,20,1,-20,20,2,10,40
19,35,5,2784,20,80,60,20,1,20,20,-2.25,10,40
19,36,6,4275,-20,20,40,20,1,-20,20,1,-10,60
19,37,7,2554,40,60,20,40,1,-40,40,0.875,50,60
19,38,8,2906,-15,0,15,15,1,-25,25,-2.333333333,-10,40
19,39,9,2817,45,100,55,45,1,-5,5,0.888888889,50,60
19,40,10,2666,-75,20,95,75,1,35,35,1.266666667,-70,60
19,41,11,2641,10,60,50,10,1,10,10,-2,10,40
19,42,12,3433,-30,0,30,30,1,-10,10,-0.833333333,-30,40
19,43,13,2626,40,40,0,40,1,-60,60,1.125,50,60
19,44,14,2745,-15,40,55,15,1,15,15,1.333333333,-10,40
19,45,15,2800,35,80,45,35,1,-15,15,0.428571429,30,60
19,46,16,2602,-15,20,35,15,1,-5,5,-1.333333333,-10,40
19,47,17,3353,0,60,60,0,1,0,0,,,60
19,48,18,3705,60,100,40,60,1,-20,20,0.666666667,50,60
19,49,19,2753,25,80,55,25,1,15,15,1.6,30,40
19,50,20,2952,-75,20,95,75,1,55,55,0.466666667,-70,40
19,51,21,3379,0,80,80,0,1,20,20,,,60
19,52,22,3032,40,100,60,40,1,0,0,0.75,50,60
19,53,23,3690,-60,0,60,60,1,20,20,-0.25,-50,40
19,54,24,3364,-30,60,90,30,1,30,30,1,-30,60
19,55,25,2705,-35,40,75,35,1,35,35,0.714285714,-30,40
19,56,26,3617,-40,20,60,40,1,0,0,0,-50,60
19,57,27,4705,30,80,50,30,1,10,10,0.166666667,30,40
19,58,28,3993,5,60,55,5,1,15,15,,10,40
19,59,29,4065,-20,40,60,20,1,0,0,,-10,60
20,0,0,2853,-25,40,65,25,0,5,5,0.8,-30,60
20,1,1,2631,0,60,60,0,0,20,20,,,40
20,2,2,3045,-15,50,65,15,0,25,25,2,-10,40
20,3,3,2593,35,80,45,35,0,-15,15,0.857142857,30,60
20,4,4,3189,-25,50,75,25,0,15,15,1,-30,60
20,5,5,2750,-5,30,35,5,0,-5,5,-2,-10,40
20,6,6,2553,-25,20,45,25,0,5,5,-0.4,-30,40
20,7,7,2663,10,60,50,10,0,-10,10,0.5,10,60
20,8,8,2807,-15,40,55,15,0,15,15,1.666666667,-10,40
20,9,9,2649,15,70,55,15,0,-5,5,0.666666667,10,60
20,10,10,3087,-10,20,30,10,0,-10,10,0,-10,40
20,11,11,2906,-5,60,65,5,0,5,5,-3,-10,60
20,12,12,3105,-40,40,80,40,0,20,20,0.125,-50,60
20,13,13,2852,0,30,30,0,0,-10,10,,,40
20,14,14,3270,-25,50,75,25,0,15,15,0.6,-30,60
20,15,15,3651,5,50,45,5,0,5,5,-1,10,40
20,16,16,2730,10,70,60,10,0,0,0,-0.5,10,60
20,17,17,2986,20,60,40,20,0,0,0,-0.75,10,40
20,18,18,3180,25,80,55,25,0,-5,5,0.4,30,60
20,19,19,2860,15,40,25,15,0,-15,15,1.333333333,10,40
20,20,20,3061,5,70,65,5,0,5,5,-5,10,60
20,21,21,2874,20,60,40,20,0,-20,20,1.25,10,60
20,22,22,2836,5,50,45,5,0,5,5,3,10,40
20,23,23,3028,-20,40,60,20,0,20,20,0.5,-10,40
20,24,24,2629,15,80,65,15,0,5,5,1,10,60
20,25,25,2715,-30,20,50,30,0,10,10,0,-30,40
20,26,26,2800,10,60,50,10,0,10,10,-0.5,10,40
20,27,27,3398,-30,50,80,30,0,20,20,0.166666667,-30,60
20,28,28,3320,-35,40,75,35,0,15,15,,-30,60
20,29,29,3494,-15,30,45,15,0,5,5,,-10,40
20,30,0,3339,0,80,80,0,1,40,40,,,40
20,31,1,2834,55,100,45,55,1,-15,15,0.818181818,50,60
20,32,2,2785,-70,0,70,70,1,30,30,0.857142857,-70,40
20,33,3,2811,-10,80,90,10,1,30,30,0.5,-10,60
20,34,4,2817,50,60,10,50,1,-30,30,0.9,50,40
20,35,5,2867,-15,40,55,15,1,15,15,0,-10,40
20,36,6,3674,-65,20,85,65,1,25,25,0.769230769,-70,60
20,37,7,2797,25,60,35,25,1,-25,25,0.6,30,60
20,38,8,2688,-35,20,55,35,1,15,15,0.142857143,-30,40
20,39,9,2601,-10,40,50,10,1,-10,10,0,-10,60
20,40,10,2749,10,60,50,10,1,-10,10,1,10,60
20,41,11,2754,-10,40,50,10,1,10,10,1,-10,40
20,42,12,2660,-40,0,40,40,1,0,0,-0.625,-50,40
20,43,13,2550,-40,20,60,40,1,0,0,0.25,-50,60
20,44,14,2637,15,80,65,15,1,25,25,0.333333333,10,40
20,45,15,2572,30,80,50,30,1,-10,10,-1.333333333,30,60
20,46,16,2868,-10,60,70,10,1,30,30,3.5,-10,40
20,47,17,3462,30,40,10,30,1,-50,50,0.833333333,30,60
20,48,18,3222,65,100,35,65,1,-25,25,0.384615385,70,60
20,49,19,2770,-15,20,35,15,1,-5,5,-3,-10,40
20,50,20,2812,-40,40,80,40,1,40,40,0.75,-50,40
20,51,21,2950,-20,40,60,20,1,0,0,1,-10,60
20,52,22,2670,60,100,40,60,1,-20,20,0,50,60
20,53,23,2900,10,60,50,10,1,10,10,1,10,40
20,54,24,2705,40,80,40,40,1,-20,20,0,50,60
20,55,25,3671,-60,0,60,60,1,20,20,0.333333333,-50,40
20,56,26,2829,20,60,40,20,1,-20,20,0.75,10,60
20,57,27,3164,-20,20,40,20,1,0,0,0,-10,40
20,58,28,2978,40,80,40,40,1,0,0,,50,40
20,59,29,2775,-35,20,55,35,1,-5,5,,-30,60
21,0,0,3903,14,80,66,14,1,26,26,0.857142857,10,40
21,1,1,3378,8,40,32,8,1,-28,28,1.25,10,60
21,2,2,3203,-38,40,78,38,1,38,38,0.605263158,-30,40
21,3,3,3436,38,80,42,38,1,-18,18,-0.210526316,30,60
21,4,4,3122,-55,0,55,55,1,15,15,0.2,-50,40
21,5,5,3291,16,60,44,16,1,4,4,1.3125,10,40
21,6,6,3390,-14,20,34,14,1,-26,26,0.785714286,-10,60
21,7,7,3160,77,100,23,77,1,-37,37,0.415584416,70,60
21,8,8,3647,-45,20,65,45,1,25,25,0.666666667,-50,40
21,9,9,3105,5,60,55,5,1,-5,5,-2.2,10,60
21,10,10,3625,16,60,44,16,1,-16,16,0.6875,10,60
21,11,11,3960,5,40,35,5,1,-5,5,-2.6,10,40
21,12,12,3210,58,80,22,58,1,-18,18,0.224137931,50,40
21,13,13,3225,-15,40,55,15,1,-5,5,-0.666666667,-10,60
21,14,14,3970,-35,0,35,35,1,-5,5,-0.285714286,-30,40
21,15,15,3269,15,80,65,15,1,5,5,0.666666667,10,60
21,16,16,3542,-25,20,45,25,1,5,5,0.4,-30,40
21,17,17,3830,-55,20,75,55,1,15,15,0.181818182,-50,60
21,18,18,3213,35,100,65,35,1,5,5,-0.285714286,30,60
21,19,19,3900,25,60,35,25,1,-5,5,0.4,30,40
21,20,20,3242,35,80,45,35,1,5,5,-0.657142857,30,40
21,21,21,3226,45,100,55,45,1,-5,5,0.222222222,50,60
21,22,22,3374,-25,40,65,25,1,5,5,0.84,-30,60
21,23,23,3555,18,40,22,18,1,-18,18,0.722222222,10,40
21,24,24,3594,36,80,44,36,1,-16,16,0.305555556,30,60
21,25,25,4105,-15,20,35,15,1,-5,5,0,-10,40
21,26,26,3230,-35,20,55,35,1,-5,5,0.571428571,-30,60
21,27,27,3893,25,60,35,25,1,-5,5,-0.4,30,40
21,28,28,4016,-25,0,25,25,1,-15,15,,-30,40
21,29,29,3590,25,60,35,25,1,-25,25,,30,60
21,30,0,4902,15,60,45,15,0,-15,15,1.333333333,10,60
21,31,1,4173,-5,30,35,5,0,-5,5,-4,-10,40
21,32,2,3018,-15,40,55,15,0,15,15,1.333333333,-10,40
21,33,3,3051,-15,50,65,15,0,5,5,-0.666666667,-10,60
21,34,4,4399,-35,40,75,35,0,15,15,0,-30,60
21,35,5,3567,-15,20,35,15,0,-5,5,0,-10,40
21,36,6,3777,25,60,35,25,0,-5,5,-0.8,30,40
21,37,7,3656,5,80,75,5,0,15,15,-2,10,60
21,38,8,3619,35,50,15,35,0,-25,25,0.571428571,30,40
21,39,9,4281,5,70,65,5,0,5,5,0,10,60
21,40,10,3648,-5,30,35,5,0,-5,5,2,-10,40
21,41,11,3541,5,70,65,5,0,5,5,2,10,60
21,42,12,3609,-15,60,75,15,0,15,15,0.666666667,-10,60
21,43,13,3494,25,50,25,25,0,-15,15,0.8,30,40
21,44,14,3159,15,80,65,15,0,5,5,-0.666666667,10,60
21,45,15,3076,15,60,45,15,0,5,5,-1.333333333,10,40
21,46,16,3082,-5,50,55,5,0,-5,5,0,-10,60
21,47,17,3569,-5,20,25,5,0,-15,15,0.6,-10,40
21,48,18,3187,-15,40,55,15,0,-5,5,0.666666667,-10,60
21,49,19,3905,18,40,22,18,0,-18,18,0.166666667,10,40
21,50,20,3178,25,70,45,25,0,-15,15,0.8,30,60
21,51,21,3442,15,80,65,15,0,5,5,0,10,60
21,52,22,3494,25,50,25,25,0,-15,15,0.8,30,40
21,53,23,3335,15,60,45,15,0,5,5,-0.666666667,10,40
21,54,24,3430,-5,60,65,5,0,5,5,-2,-10,60
21,55,25,4007,-15,20,35,15,0,-5,5,0.666666667,-10,40
21,56,26,3504,15,40,25,15,0,-15,15,0.666666667,10,40
21,57,27,3494,-25,50,75,25,0,15,15,0.4,-30,60
21,58,28,3250,-25,40,65,25,0,5,5,,-30,60
21,59,29,3587,-5,30,35,5,0,-5,5,,-10,40
22,0,0,3928,-25,20,45,25,1,5,5,0.6,-30,40
22,1,1,3738,-20,60,80,20,1,20,20,1.25,-10,60
22,2,2,3632,50,80,30,50,1,-10,10,0,50,40
22,3,3,3648,-15,40,55,15,1,-5,5,-1.666666667,-10,60
22,4,4,5147,10,40,30,10,1,-10,10,1.5,10,40
22,5,5,3681,15,60,45,15,1,5,5,0.333333333,10,40
22,6,6,3688,0,80,80,0,1,20,20,,,60
22,7,7,3698,60,100,40,60,1,-20,20,0.5,50,60
22,8,8,5587,-50,0,50,50,1,10,10,0,-50,40
22,9,9,4962,-50,20,70,50,1,10,10,0.4,-50,60
22,10,10,4166,30,80,50,30,1,-10,10,0,30,60
22,11,11,3652,-30,20,50,30,1,10,10,0,-30,40
22,12,12,3671,-10,40,50,10,1,10,10,0,-10,40
22,13,13,3578,50,100,50,50,1,-10,10,0.2,50,60
22,14,14,3658,30,80,50,30,1,10,10,-0.333333333,30,40
22,15,15,3881,0,60,60,0,1,0,0,,,60
22,16,16,3563,20,60,40,20,1,0,0,0,10,40
22,17,17,2976,-20,40,60,20,1,0,0,0,-10,60
22,18,18,2792,-40,20,60,40,1,0,0,0,-50,60
22,19,19,3818,-40,0,40,40,1,0,0,0,-50,40
22,20,20,2875,-20,20,40,20,1,0,0,0,-10,40
22,21,21,2856,40,100,60,40,1,0,0,0,50,60
22,22,22,2820,20,80,60,20,1,0,0,0,10,60
22,23,23,2838,40,80,40,40,1,0,0,0,50,40
22,24,24,2925,-20,40,60,20,1,0,0,0,-10,60
22,25,25,2828,20,60,40,20,1,0,0,0,10,40
22,26,26,2745,0,60,60,0,1,0,0,,,60
22,27,27,2833,-40,0,40,40,1,0,0,0,-50,40
22,28,28,2824,0,40,40,0,1,0,0,,,40
22,29,29,2803,-40,20,60,40,1,0,0,,-50,60
22,30,0,3246,20,70,50,20,0,-10,10,0.5,10,60
22,31,1,3095,0,50,50,0,0,10,10,,,40
22,32,2,2743,-20,30,50,20,0,10,10,0.5,-10,40
22,33,3,3092,0,60,60,0,0,0,0,,,60
22,34,4,2727,-20,40,60,20,0,0,0,0,-10,60
22,35,5,2779,-20,20,40,20,0,0,0,0,-10,40
22,36,6,2821,20,60,40,20,0,0,0,0,10,40
22,37,7,2846,-10,50,60,10,0,0,0,0,-10,60
22,38,8,2884,0,40,40,0,0,0,0,,,40
22,39,9,2871,20,80,60,20,0,0,0,0,10,60
22,40,10,2798,-20,20,40,20,0,0,0,0,-10,40
22,41,11,2871,-20,40,60,20,0,0,0,0,-10,60
22,42,12,2779,0,60,60,0,0,0,0,,,60
22,43,13,2848,0,40,40,0,0,0,0,,,40
22,44,14,2903,10,70,60,10,0,0,0,0,10,60
22,45,15,2810,10,50,40,10,0,0,0,0,10,40
22,46,16,2783,20,80,60,20,0,0,0,0,10,60
22,47,17,2897,-10,30,40,10,0,0,0,0,-10,40
22,48,18,2925,-10,50,60,10,0,0,0,0,-10,60
22,49,19,2793,20,60,40,20,0,0,0,0,10,40
22,50,20,2999,-20,40,60,20,0,0,0,0,-10,60
22,51,21,2821,-10,50,60,10,0,0,0,0,-10,60
22,52,22,2816,20,60,40,20,0,0,0,0,10,40
22,53,23,2822,-10,30,40,10,0,0,0,0,-10,40
22,54,24,2797,0,60,60,0,0,0,0,,,60
22,55,25,2755,0,40,40,0,0,0,0,,,40
22,56,26,2926,10,50,40,10,0,0,0,0.5,10,40
22,57,27,2787,10,70,60,10,0,0,0,-1.5,10,60
22,58,28,4741,35,80,45,35,0,-15,15,,30,60
22,59,29,2884,-25,20,45,25,0,5,5,,-30,40
23,0,0,7007,5,80,75,5,0,15,15,-3,10,60
23,1,1,7006,20,60,40,20,0,0,0,0.5,10,40
23,2,2,7005,-30,20,50,30,0,10,10,0.5,-30,40
23,3,3,7006,-10,50,60,10,0,0,0,-1.5,-10,60
23,4,4,7007,-15,60,75,15,0,15,15,-1.666666667,-10,60
23,5,5,7006,15,50,35,15,0,-5,5,1,10,40
23,6,6,7006,-20,30,50,20,0,10,10,0,-10,40
23,7,7,7004,-30,70,100,30,0,40,40,1.666666667,-30,60
23,8,8,7007,-10,40,50,10,0,10,10,0,-10,40
23,9,9,7006,-10,40,50,10,0,-10,10,-2,-10,60
23,10,10,7004,-30,20,50,30,0,10,10,-0.166666667,-30,40
23,11,11,7005,-20,50,70,20,0,10,10,0.5,-10,60
23,12,12,7005,0,60,60,0,0,0,0,,,60
23,13,13,7005,5,60,55,5,0,15,15,-3,10,40
23,14,14,7005,20,70,50,20,0,-10,10,1.5,10,60
23,15,15,7007,0,40,40,0,0,0,0,,,40
23,16,16,7005,0,80,80,0,0,20,20,,,60
23,17,17,7006,-20,30,50,20,0,10,10,0.75,-10,40
23,18,18,7005,-40,40,80,40,0,20,20,0.25,-50,60
23,19,19,7005,15,50,35,15,0,-5,5,0.333333333,10,40
23,20,20,7004,0,70,70,0,0,10,10,,,60
23,21,21,7006,0,60,60,0,0,0,0,,,60
23,22,22,7006,0,40,40,0,0,0,0,,,40
23,23,23,7006,0,50,50,0,0,10,10,,,40
23,24,24,7004,-15,50,65,15,0,5,5,1,-10,60
23,25,25,7005,-20,30,50,20,0,10,10,1.5,-10,40
23,26,26,7007,40,60,20,40,0,-20,20,0.75,50,40
23,27,27,7006,-10,40,50,10,0,-10,10,-1.5,-10,60
23,28,28,7005,15,80,65,15,0,5,5,,10,60
23,29,29,7004,-30,20,50,30,0,10,10,,-30,40
23,30,0,7007,15,80,65,15,1,25,25,1,10,40
23,31,1,7004,50,100,50,50,1,-10,10,0.5,50,60
23,32,2,7006,-80,0,80,80,1,40,40,0.375,-70,40
23,33,3,7004,5,80,75,5,1,15,15,-5,10,60
23,34,4,7005,10,60,50,10,1,10,10,0,10,40
23,35,5,7004,-30,20,50,30,1,10,10,-0.5,-30,40
23,36,6,7005,-10,40,50,10,1,-10,10,-3,-10,60
23,37,7,7006,-20,60,80,20,1,20,20,1.5,-10,60
23,38,8,7004,-25,40,65,25,1,25,25,1,-30,40
23,39,9,7004,-30,20,50,30,1,-10,10,0.833333333,-30,60
23,40,10,7004,35,60,25,35,1,-35,35,0.714285714,30,60
23,41,11,7005,40,80,40,40,1,0,0,0.25,50,40
23,42,12,7005,-30,20,50,30,1,10,10,,-30,40
23,43,13,7005,-30,20,50,30,1,-10,10,0,-30,60
23,44,14,7004,,40,,,1,,,,,40
23,45,15,7003,30,80,50,30,1,-10,10,1,30,60
23,46,16,7006,-25,0,25,25,1,-15,15,-1,-30,40
23,47,17,7004,20,100,80,20,1,20,20,0.25,10,60
23,48,18,7007,-45,40,85,45,1,25,25,0,-50,60
23,49,19,7008,10,60,50,10,1,10,10,0,10,40
23,50,20,7005,10,60,50,10,1,10,10,-4,10,40
23,51,21,7006,-45,40,85,45,1,25,25,0.777777778,-50,60
23,52,22,7005,10,60,50,10,1,-10,10,0,10,60
23,53,23,7005,70,80,10,70,1,-30,30,0.214285714,70,40
23,54,24,7006,30,80,50,30,1,-10,10,1,30,60
23,55,25,7006,15,40,25,15,1,-15,15,1.666666667,10,40
23,56,26,7005,20,100,80,20,1,20,20,0,10,60
23,57,27,7007,-50,0,50,50,1,10,10,0.2,-50,40
23,58,28,7028,-20,20,40,20,1,0,0,,-10,40
23,59,29,7006,-60,20,80,60,1,20,20,,-50,60
24,0,0,7024,40,60,20,40,0,-40,40,0.75,50,60
24,1,1,7025,-10,40,50,10,0,10,10,1,-10,40
24,2,2,7027,10,50,40,10,0,0,0,1,10,40
24,3,3,7022,20,70,50,20,0,-10,10,0,10,60
24,4,4,7021,-10,40,50,10,0,-10,10,-1,-10,60
24,5,5,7016,-30,20,50,30,0,10,10,1,-30,40
24,6,6,7018,10,30,20,10,0,-20,20,7,10,40
24,7,7,7025,-10,50,60,10,0,0,0,-1,-10,60
24,8,8,7015,-30,60,90,30,0,50,50,1,-30,40
24,9,9,7012,10,80,70,10,0,10,10,-2,10,60
24,10,10,7029,-40,20,60,40,0,20,20,0.25,-50,40
24,11,11,7022,-10,40,50,10,0,-10,10,1,-10,60
24,12,12,7019,30,70,40,30,0,-20,20,0.333333333,30,60
24,13,13,7017,-10,40,50,10,0,10,10,1,-10,40
24,14,14,7016,10,60,50,10,0,-10,10,0,10,60
24,15,15,7015,-10,30,40,10,0,0,0,-1,-10,40
24,16,16,7029,30,80,50,30,0,-10,10,-0.333333333,30,60
24,17,17,7016,0,50,50,0,0,10,10,,,40
24,18,18,7005,10,50,40,10,0,-20,20,4,10,60
24,19,19,7003,40,60,20,40,0,-20,20,0.25,50,40
24,20,20,7012,0,80,80,0,0,20,20,,,60
24,21,21,7013,-30,40,70,30,0,10,10,0,-30,60
24,22,22,7025,20,50,30,20,0,-10,10,1,10,40
24,23,23,7018,10,60,50,10,0,10,10,-2,10,40
24,24,24,7018,0,70,70,0,0,10,10,,,60
24,25,25,7018,10,40,30,10,0,-10,10,0,10,40
24,26,26,7024,0,30,30,0,0,-10,10,,,40
24,27,27,7028,0,50,50,0,0,-10,10,,,60
24,28,28,7018,-10,60,70,10,0,10,10,,-10,60
24,29,29,7018,-30,20,50,30,0,10,10,,-30,40
24,30,0,7022,10,40,30,10,1,-10,10,4,10,40
24,31,1,7008,30,80,50,30,1,-10,10,-1,30,60
24,32,2,7028,-10,60,70,10,1,30,30,1,-10,40
24,33,3,7029,20,40,20,20,1,-40,40,1.5,10,60
24,34,4,7014,-60,0,60,60,1,20,20,0,-50,40
24,35,5,7015,-40,20,60,40,1,20,20,-0.25,-50,40
24,36,6,7006,50,100,50,50,1,-10,10,0,50,60
24,37,7,7011,10,60,50,10,1,-10,10,2,10,60
24,38,8,7019,10,80,70,10,1,30,30,-2,10,40
24,39,9,7017,-50,20,70,50,1,10,10,0,-50,60
24,40,10,7015,-10,60,70,10,1,10,10,2,-10,60
24,41,11,7010,-30,20,50,30,1,10,10,0,-30,40
24,42,12,7014,-50,0,50,50,1,10,10,0,-50,40
24,43,13,7029,50,100,50,50,1,-10,10,-0.9,50,60
24,44,14,7027,10,60,50,10,1,10,10,1,10,40
24,45,15,7023,75,80,5,75,1,-55,55,0.6,70,60
24,46,16,7017,-20,40,60,20,1,20,20,0,-10,40
24,47,17,7024,-10,40,50,10,1,-10,10,1,-10,60
24,48,18,7012,-20,20,40,20,1,-20,20,1,-10,60
24,49,19,7016,20,80,60,20,1,20,20,-1.5,10,40
24,50,20,7008,-30,0,30,30,1,-10,10,-1,-30,40
24,51,21,7030,0,20,20,0,1,-40,40,,,60
24,52,22,7015,40,100,60,40,1,0,0,-0.5,50,60
24,53,23,7004,-40,20,60,40,1,20,20,0.25,-50,40
24,54,24,7014,40,80,40,40,1,-20,20,0,50,60
24,55,25,7019,10,60,50,10,1,10,10,0,10,40
24,56,26,7022,0,40,40,0,1,-20,20,,,60
24,57,27,7007,30,80,50,30,1,10,10,0.666666667,30,40
24,58,28,7014,-30,40,70,30,1,30,30,,-30,40
24,59,29,7013,20,60,40,20,1,-20,20,,10,60
25,0,0,4563,20,60,40,20,1,0,0,1.5,10,40
25,1,1,11323,10,60,50,10,1,-10,10,-1,10,60
25,2,2,5148,-50,20,70,50,1,30,30,0.8,-50,40
25,3,3,5690,40,80,40,40,1,-20,20,1,50,60
25,4,4,4666,-30,0,30,30,1,-10,10,-1.333333333,-30,40
25,5,5,5407,-30,40,70,30,1,30,30,-0.333333333,-30,40
25,6,6,5003,-60,20,80,60,1,20,20,0.5,-50,60
25,7,7,4553,-10,40,50,10,1,-10,10,0,-10,60
25,8,8,4610,0,80,80,0,1,40,40,,,40
25,9,9,6196,50,100,50,50,1,-10,10,0,50,60
25,10,10,7010,30,80,50,30,1,-10,10,-1,30,60
25,11,11,5094,-30,40,70,30,1,30,30,-0.666666667,-30,40
25,12,12,4231,-30,60,90,30,1,50,50,1.333333333,-30,40
25,13,13,4570,20,40,20,20,1,-40,40,1.5,10,60
25,14,14,4313,-30,20,50,30,1,10,10,0.333333333,-30,40
25,15,15,7006,-30,20,50,30,1,-10,10,1,-30,60
25,16,16,4822,40,80,40,40,1,0,0,0.75,50,40
25,17,17,9614,80,100,20,80,1,-40,40,0.375,70,60
25,18,18,4577,10,60,50,10,1,-10,10,0,10,60
25,19,19,4666,-70,0,70,70,1,30,30,0.285714286,-70,40
25,20,20,5349,-30,20,50,30,1,10,10,0,-30,40
25,21,21,5129,-10,40,50,10,1,-10,10,2,-10,60
25,22,22,4744,30,60,30,30,1,-30,30,-0.333333333,30,60
25,23,23,4711,-50,0,50,50,1,10,10,0.4,-50,40
25,24,24,5103,80,100,20,80,1,-40,40,0.25,70,60
25,25,25,4438,10,40,30,10,1,-10,10,2,10,40
25,26,26,4667,40,80,40,40,1,-20,20,1.25,50,60
25,27,27,4484,30,80,50,30,1,10,10,1,30,40
25,28,28,4399,-20,60,80,20,1,40,40,,-10,40
25,29,29,4454,-70,20,90,70,1,30,30,,-70,60
25,30,0,4161,10,40,30,10,0,-30,30,1,10,60
25,31,1,4043,10,30,20,10,0,-20,20,5,10,40
25,32,2,3969,-10,60,70,10,0,30,30,2,-10,40
25,33,3,5615,20,60,40,20,0,-20,20,2,10,60
25,34,4,4121,0,80,80,0,0,20,20,,,60
25,35,5,4425,-10,40,50,10,0,10,10,-3,-10,40
25,36,6,3693,-30,50,80,30,0,40,40,0.666666667,-30,40
25,37,7,4121,40,70,30,40,0,-30,30,0.5,50,60
25,38,8,4147,-40,20,60,40,0,20,20,-0.25,-50,40
25,39,9,11792,0,50,50,0,0,-10,10,,,60
25,40,10,4217,-50,20,70,50,0,30,30,0.8,-50,40
25,41,11,4602,20,60,40,20,0,-20,20,1.5,10,60
25,42,12,4434,-20,50,70,20,0,10,10,0.5,-10,60
25,43,13,4412,30,60,30,30,0,-10,10,1.333333333,30,40
25,44,14,4305,-20,40,60,20,0,0,0,-1,-10,60
25,45,15,4470,-30,40,70,30,0,30,30,1.333333333,-30,40
25,46,16,4160,-10,70,80,10,0,20,20,0,-10,60
25,47,17,4084,20,50,30,20,0,-10,10,0,10,40
25,48,18,7872,0,80,80,0,0,20,20,,,60
25,49,19,4161,0,30,30,0,0,-10,10,,,40
25,50,20,4960,-30,60,90,30,0,30,30,1,-30,60
25,51,21,3621,-20,40,60,20,0,0,0,2,-10,60
25,52,22,5420,-20,30,50,20,0,10,10,1.5,-10,40
25,53,23,4449,20,40,20,20,0,-20,20,2.5,10,40
25,54,24,4467,60,80,20,60,0,-40,40,1.166666667,50,60
25,55,25,4574,-10,60,70,10,0,30,30,-2,-10,40
25,56,26,4067,-40,50,90,40,0,50,50,0.75,-50,40
25,57,27,4484,-40,50,90,40,0,30,30,0.5,-50,60
25,58,28,4089,0,70,70,0,0,10,10,,,60
25,59,29,4126,-40,20,60,40,0,20,20,,-50,40
26,0,0,4293,40,80,40,40,1,0,0,0.75,50,40
26,1,1,3821,40,80,40,40,1,-20,20,0.5,50,60
26,2,2,3567,-50,20,70,50,1,30,30,0,-50,40
26,3,3,3727,-40,20,60,40,1,0,0,-0.25,-50,60
26,4,4,3835,-10,60,70,10,1,30,30,-1,-10,40
26,5,5,3192,-80,0,80,80,1,40,40,0.375,-70,40
26,6,6,2992,-10,60,70,10,1,10,10,2,-10,60
26,7,7,3745,-10,40,50,10,1,-10,10,-2,-10,60
26,8,8,4237,-10,40,50,10,1,10,10,1,-10,40
26,9,9,4030,30,100,70,30,1,10,10,0.666666667,30,60
26,10,10,3089,-50,40,90,50,1,30,30,0.4,-50,60
26,11,11,3808,-40,0,40,40,1,0,0,0.25,-50,40
26,12,12,3458,-10,20,30,10,1,-10,10,0,-10,40
26,13,13,3183,-50,20,70,50,1,10,10,-0.2,-50,60
26,14,14,3449,50,80,30,50,1,-10,10,0.2,50,40
26,15,15,3691,-20,60,80,20,1,20,20,1,-10,60
26,16,16,3458,20,60,40,20,1,0,0,0,10,40
26,17,17,2984,40,100,60,40,1,0,0,0.5,50,60
26,18,18,2984,0,80,80,0,1,20,20,,,60
26,19,19,3946,0,40,40,0,1,0,0,,,40
26,20,20,3401,10,40,30,10,1,-10,10,2,10,40
26,21,21,4000,10,80,70,10,1,10,10,-1,10,60
26,22,22,3716,40,100,60,40,1,0,0,0.75,50,60
26,23,23,3009,-50,0,50,50,1,10,10,0.4,-50,40
26,24,24,2768,-30,60,90,30,1,30,30,0.666666667,-30,60
26,25,25,2832,-10,20,30,10,1,-10,10,1,-10,40
26,26,26,2887,-30,40,70,30,1,10,10,0,-30,60
26,27,27,2827,40,60,20,40,1,-20,20,-0.25,50,40
26,28,28,3245,70,80,10,70,1,-30,30,,70,40
26,29,29,3526,-50,20,70,50,1,10,10,,-50,60
26,30,0,4601,30,50,20,30,0,-40,40,1.666666667,30,60
26,31,1,3720,-10,30,40,10,0,0,0,0,-10,40
26,32,2,3143,-20,20,40,20,0,0,0,0.5,-10,40
26,33,3,2976,0,70,70,0,0,10,10,,,60
26,34,4,3071,-40,40,80,40,0,20,20,0,-50,60
26,35,5,3671,30,60,30,30,0,-10,10,-0.333333333,30,40
26,36,6,2936,30,50,20,30,0,-20,20,1,30,40
26,37,7,2877,0,80,80,0,0,20,20,,,60
26,38,8,3288,-10,40,50,10,0,10,10,1,-10,40
26,39,9,3368,-10,60,70,10,0,10,10,1,-10,60
26,40,10,2919,20,60,40,20,0,0,0,0,10,40
26,41,11,3279,-10,50,60,10,0,0,0,-1,-10,60
26,42,12,3143,0,70,70,0,0,10,10,,,60
26,43,13,3528,-20,20,40,20,0,0,0,1.5,-10,40
26,44,14,2935,-30,60,90,30,0,30,30,1.333333333,-30,60
26,45,15,2688,20,30,10,20,0,-30,30,1,10,40
26,46,16,3061,-10,40,50,10,0,-10,10,-3,-10,60
26,47,17,3599,10,40,30,10,0,-10,10,-2,10,40
26,48,18,2631,0,80,80,0,0,20,20,,,60
26,49,19,2726,40,50,10,40,0,-30,30,1,50,40
26,50,20,2903,-10,50,60,10,0,0,0,0,-10,60
26,51,21,3760,0,60,60,0,0,0,0,,,60
26,52,22,2904,10,60,50,10,0,10,10,1,10,40
26,53,23,3094,-10,50,60,10,0,20,20,-3,-10,40
26,54,24,3215,-10,80,90,10,0,30,30,4,-10,60
26,55,25,2907,-70,20,90,70,0,50,50,0.571428571,-70,40
26,56,26,3087,-20,30,50,20,0,10,10,1,-10,40
26,57,27,3556,-10,40,50,10,0,-10,10,-2,-10,60
26,58,28,3129,0,70,70,0,0,10,10,,,60
26,59,29,2912,10,40,30,10,0,-10,10,,10,40
27,0,0,5307,0,60,60,0,1,20,20,,,40
27,1,1,4358,-10,40,50,10,1,-10,10,-1,-10,60
27,2,2,4050,-60,0,60,60,1,20,20,0.5,-50,40
27,3,3,4658,40,100,60,40,1,0,0,-0.25,50,60
27,4,4,4782,-10,20,30,10,1,-10,10,-1,-10,40
27,5,5,3792,40,80,40,40,1,0,0,0.75,50,40
27,6,6,4142,-30,20,50,30,1,-10,10,-0.333333333,-30,60
27,7,7,6374,0,60,60,0,1,0,0,,,60
27,8,8,5747,-30,40,70,30,1,30,30,1.333333333,-30,40
27,9,9,4432,20,80,60,20,1,0,0,0.5,10,60
27,10,10,4457,10,80,70,10,1,10,10,-2,10,60
27,11,11,6068,50,80,30,50,1,-10,10,0.2,50,40
27,12,12,5823,-20,20,40,20,1,0,0,-2.5,-10,40
27,13,13,5070,50,100,50,50,1,-10,10,0.4,50,60
27,14,14,4819,-30,60,90,30,1,50,50,1.333333333,-30,40
27,15,15,4591,-50,20,70,50,1,10,10,0.2,-50,60
27,16,16,4072,-50,0,50,50,1,10,10,-0.2,-50,40
27,17,17,4895,0,60,60,0,1,0,0,,,60
27,18,18,5339,0,40,40,0,1,-20,20,,,60
27,19,19,4587,-20,40,60,20,1,20,20,0.5,-10,40
27,20,20,4539,-10,40,50,10,1,10,10,2,-10,40
27,21,21,3662,10,80,70,10,1,10,10,1,10,60
27,22,22,3564,-40,40,80,40,1,20,20,0.75,-50,60
27,23,23,5422,30,60,30,30,1,-10,10,0.333333333,30,40
27,24,24,4286,-30,20,50,30,1,-10,10,0.333333333,-30,60
27,25,25,7025,-40,0,40,40,1,0,0,0.5,-50,40
27,26,26,5498,60,100,40,60,1,-20,20,0.333333333,50,60
27,27,27,6243,60,80,20,60,1,-20,20,0.5,50,40
27,28,28,4588,-30,20,50,30,1,10,10,,-30,40
27,29,29,4418,0,60,60,0,1,0,0,,,60
27,30,0,4795,10,60,50,10,0,-10,10,-1,10,60
27,31,1,3485,-10,40,50,10,0,10,10,1,-10,40
27,32,2,5185,20,60,40,20,0,0,0,1,10,40
27,33,3,4136,10,50,40,10,0,-20,20,2,10,60
27,34,4,3722,-20,40,60,20,0,0,0,-0.25,-10,60
27,35,5,3737,-30,30,60,30,0,20,20,0.666666667,-30,40
27,36,6,4790,10,50,40,10,0,0,0,1,10,40
27,37,7,4848,15,80,65,15,0,5,5,-0.333333333,10,60
27,38,8,3471,-30,20,50,30,0,10,10,0,-30,40
27,39,9,3903,10,70,60,10,0,0,0,2,10,60
27,40,10,3564,-10,40,50,10,0,10,10,0,-10,40
27,41,11,3604,-40,40,80,40,0,20,20,1,-50,60
27,42,12,7002,10,50,40,10,0,-20,20,2,10,60
27,43,13,3081,-30,20,50,30,0,10,10,0,-30,40
27,44,14,3550,20,80,60,20,0,0,0,0,10,60
27,45,15,3536,0,50,50,0,0,10,10,,,40
27,46,16,3383,10,70,60,10,0,0,0,1,10,60
27,47,17,4085,0,30,30,0,0,-10,10,,,40
27,48,18,6355,-10,60,70,10,0,10,10,1,-10,60
27,49,19,5153,20,60,40,20,0,0,0,0.5,10,40
27,50,20,3829,20,80,60,20,0,0,0,-1,10,60
27,51,21,3854,0,40,40,0,0,-20,20,,,60
27,52,22,7015,10,60,50,10,0,10,10,1,10,40
27,53,23,4286,-40,20,60,40,0,20,20,0.25,-50,40
27,54,24,3414,-20,50,70,20,0,10,10,0.5,-10,60
27,55,25,4093,-10,40,50,10,0,10,10,-1,-10,40
27,56,26,5224,-30,30,60,30,0,20,20,0.666666667,-30,40
27,57,27,3788,0,60,60,0,0,0,0,,,60
27,58,28,3590,20,70,50,20,0,-10,10,,10,60
27,59,29,3778,10,50,40,10,0,0,0,,10,40
28,0,0,2813,-10,60,70,10,1,30,30,3,-10,40
28,1,1,2608,60,80,20,60,1,-40,40,0.833333333,50,60
28,2,2,2561,0,40,40,0,1,0,0,,,40
28,3,3,2653,-50,20,70,50,1,10,10,0,-50,60
28,4,4,2581,-40,0,40,40,1,0,0,0.5,-50,40
28,5,5,2660,60,80,20,60,1,-20,20,0.333333333,50,40
28,6,6,2680,-10,60,70,10,1,10,10,1,-10,60
28,7,7,3014,-20,40,60,20,1,0,0,-0.5,-10,60
28,8,8,3360,-20,20,40,20,1,0,0,-0.5,-10,40
28,9,9,2616,30,100,70,30,1,10,10,-0.333333333,30,60
28,10,10,2576,-40,20,60,40,1,0,0,-0.25,-50,60
28,11,11,2554,10,60,50,10,1,10,10,-1,10,40
28,12,12,2601,-20,20,40,20,1,0,0,0.5,-10,40
28,13,13,2664,30,100,70,30,1,10,10,0.333333333,30,60
28,14,14,2585,10,40,30,10,1,-10,10,0,10,40
28,15,15,2765,-20,60,80,20,1,20,20,1,-10,60
28,16,16,2583,-30,0,30,30,1,-10,10,0,-30,40
28,17,17,2649,20,80,60,20,1,0,0,1,10,60
28,18,18,2551,-40,40,80,40,1,20,20,-0.25,-50,60
28,19,19,2606,50,80,30,50,1,-10,10,-0.2,50,40
28,20,20,2705,20,40,20,20,1,-20,20,1,10,40
28,21,21,2636,-50,40,90,50,1,30,30,0.2,-50,60
28,22,22,2754,-60,20,80,60,1,20,20,0,-50,60
28,23,23,2448,40,80,40,40,1,0,0,0,50,40
28,24,24,2883,0,80,80,0,1,20,20,,,60
28,25,25,2553,20,60,40,20,1,0,0,-1,10,40
28,26,26,2951,-30,60,90,30,1,30,30,0.666666667,-30,60
28,27,27,2589,-20,0,20,20,1,-20,20,-1.5,-10,40
28,28,28,2581,-30,20,50,30,1,10,10,,-30,40
28,29,29,2540,30,100,70,30,1,10,10,,30,60
28,30,0,2612,-10,60,70,10,0,10,10,-1,-10,60
28,31,1,2745,-10,20,30,10,0,-10,10,-1,-10,40
28,32,2,2935,10,50,40,10,0,0,0,0,10,40
28,33,3,2642,-30,50,80,30,0,20,20,0.333333333,-30,60
28,34,4,2697,-30,40,70,30,0,10,10,-0.333333333,-30,60
28,35,5,2552,0,40,40,0,0,0,0,,,40
28,36,6,2720,0,30,30,0,0,-10,10,,,40
28,37,7,3191,0,80,80,0,0,20,20,,,60
28,38,8,2946,40,60,20,40,0,-20,20,0.25,50,40
28,39,9,2610,10,70,60,10,0,0,0,-2,10,60
28,40,10,2641,30,60,30,30,0,-10,10,0.333333333,30,40
28,41,11,2582,40,80,40,40,0,-20,20,0.75,50,60
28,42,12,2611,-30,40,70,30,0,10,10,-0.333333333,-30,60
28,43,13,2758,0,40,40,0,0,0,0,,,40
28,44,14,2960,-10,70,80,10,0,20,20,-1,-10,60
28,45,15,2597,10,30,20,10,0,-20,20,2,10,40
28,46,16,2601,-40,50,90,40,0,30,30,0.75,-50,60
28,47,17,2562,10,50,40,10,0,0,0,-2,10,40
28,48,18,2567,0,60,60,0,0,0,0,,,60
28,49,19,2575,0,20,20,0,0,-20,20,,,40
28,50,20,2593,0,70,70,0,0,10,10,,,60
28,51,21,3003,-10,80,90,10,0,30,30,1,-10,60
28,52,22,2646,20,50,30,20,0,-10,10,0,10,40
28,53,23,2736,-10,20,30,10,0,-10,10,-2,-10,40
28,54,24,2737,-30,50,80,30,0,20,20,0.333333333,-30,60
28,55,25,2978,-10,40,50,10,0,10,10,3,-10,40
28,56,26,2538,10,30,20,10,0,-20,20,3,10,40
28,57,27,2658,-10,60,70,10,0,10,10,-2,-10,60
28,58,28,4924,-50,40,90,50,0,30,30,,-50,60
28,59,29,2789,10,60,50,10,0,10,10,,10,40
29,0,0,4226,3,70,67,3,0,7,7,0,10,60
29,1,1,3820,10,50,40,10,0,0,0,0,10,40
29,2,2,4410,-20,20,40,20,0,0,0,0.75,-10,40
29,3,3,3323,-27,40,67,27,0,7,7,-0.666666667,-30,60
29,4,4,4502,-35,50,85,35,0,25,25,0.285714286,-30,60
29,5,5,3817,15,40,25,15,0,-15,15,0,10,40
29,6,6,4674,35,60,25,35,0,-15,15,0.857142857,30,40
29,7,7,3966,-15,60,75,15,0,15,15,1.333333333,-10,60
29,8,8,3935,-25,30,55,25,0,15,15,0.8,-30,40
29,9,9,3958,25,80,55,25,0,-5,5,0.4,30,60
29,10,10,3251,25,60,35,25,0,-5,5,-0.4,30,40
29,11,11,4541,5,70,65,5,0,5,5,4.2,10,60
29,12,12,3171,-6,80,86,6,0,26,26,10.16666667,-10,60
29,13,13,4418,25,50,25,25,0,-15,15,0.8,30,40
29,14,14,3973,15,40,25,15,0,-35,35,1.333333333,10,60
29,15,15,3292,-15,30,45,15,0,5,5,1.333333333,-10,40
29,16,16,3193,5,50,45,5,0,-15,15,8,10,60
29,17,17,4191,15,40,25,15,0,-15,15,1.333333333,10,40
29,18,18,3367,-25,60,85,25,0,25,25,0.4,-30,60
29,19,19,4306,-25,20,45,25,0,5,5,0,-30,40
29,20,20,4393,-25,50,75,25,0,15,15,1.6,-30,60
29,21,21,4339,45,80,35,45,0,-25,25,0.666666667,50,60
29,22,22,3607,15,60,45,15,0,5,5,-1.333333333,10,40
29,23,23,4036,5,30,25,5,0,-15,15,6,10,40
29,24,24,3502,5,70,65,5,0,5,5,-8,10,60
29,25,25,3230,-35,20,55,35,0,15,15,0.342857143,-30,40
29,26,26,4797,7,50,43,7,0,3,3,-1.142857143,10,40
29,27,27,3268,15,40,25,15,0,-35,35,1,10,60
29,28,28,4262,20,60,40,20,0,-20,20,,10,60
29,29,29,3208,5,40,35,5,0,-5,5,,10,40
29,30,0,4657,-16,80,96,16,1,56,56,0.6875,-10,40
29,31,1,3131,35,60,25,35,1,-35,35,0,30,60
29,32,2,3291,-65,20,85,65,1,45,45,0.461538462,-70,40
29,33,3,2895,55,80,25,55,1,-35,35,1.090909091,50,60
29,34,4,3029,5,60,55,5,1,15,15,4,10,40
29,35,5,3576,-35,40,75,35,1,35,35,1,-30,40
29,36,6,3535,15,100,85,15,1,25,25,0.066666667,10,60
29,37,7,6458,-46,40,86,46,1,26,26,0.673913043,-50,60
29,38,8,3899,-40,0,40,40,1,0,0,0,-50,40
29,39,9,4055,-35,20,55,35,1,-5,5,0,-30,60
29,40,10,3947,25,80,55,25,1,-5,5,-0.6,30,60
29,41,11,4531,20,60,40,20,1,0,0,0.75,10,40
29,42,12,3025,-35,20,55,35,1,15,15,0,-30,40
29,43,13,4208,-20,20,40,20,1,-20,20,-1.75,-10,60
29,44,14,4606,-15,40,55,15,1,15,15,0.666666667,-10,40
29,45,15,3932,-35,40,75,35,1,15,15,0.857142857,-30,60
29,46,16,3700,35,80,45,35,1,5,5,0.857142857,30,40
29,47,17,3874,55,100,45,55,1,-15,15,0.727272727,50,60
29,48,18,2995,-25,60,85,25,1,25,25,2.4,-30,60
29,49,19,3095,-75,0,75,75,1,35,35,0.4,-70,40
29,50,20,4515,-45,0,45,45,1,5,5,0.222222222,-50,40
29,51,21,3331,15,40,25,15,1,-35,35,3.333333333,10,60
29,52,22,3569,5,80,75,5,1,15,15,-4,10,60
29,53,23,3710,5,40,35,5,1,-5,5,4,10,40
29,54,24,3196,45,100,55,45,1,-5,5,0.022222222,50,60
29,55,25,3771,-35,20,55,35,1,15,15,0.285714286,-30,40
29,56,26,4158,4,60,56,4,1,-4,4,-0.25,10,60
29,57,27,4799,35,80,45,35,1,5,5,-0.857142857,30,40
29,58,28,4198,45,60,15,45,1,-25,25,,50,40
29,59,29,3395,-35,20,55,35,1,-5,5,,-30,60
30,0,0,3281,20,70,50,20,0,-10,10,0.5,10,60
30,1,1,5162,10,30,20,10,0,-20,20,-2,10,40
30,2,2,2170,20,20,0,20,0,-40,40,1.5,10,40
30,3,3,2986,0,60,60,0,0,0,0,,,60
30,4,4,2721,-10,50,60,10,0,0,0,-3,-10,60
30,5,5,2984,30,60,30,30,0,-10,10,0,30,40
30,6,6,2507,10,40,30,10,0,-10,10,1,10,40
30,7,7,2782,-10,80,90,10,0,30,30,4,-10,60
30,8,8,2767,10,50,40,10,0,0,0,0,10,40
30,9,9,2849,-10,40,50,10,0,-10,10,-2,-10,60
30,10,10,2751,0,40,40,0,0,0,0,,,40
30,11,11,3668,-20,50,70,20,0,10,10,0.5,-10,60
30,12,12,2607,-20,40,60,20,0,0,0,1,-10,60
30,13,13,3948,0,30,30,0,0,-10,10,,,40
30,14,14,3321,40,80,40,40,0,-20,20,0.25,50,60
30,15,15,2772,20,60,40,20,0,0,0,0.5,10,40
30,16,16,2719,20,70,50,20,0,-10,10,1,10,60
30,17,17,2757,0,50,50,0,0,10,10,,,40
30,18,18,3017,-10,60,70,10,0,10,10,1,-10,60
30,19,19,3557,-30,20,50,30,0,10,10,0.666666667,-30,40
30,20,20,3966,10,70,60,10,0,0,0,-2,10,60
30,21,21,3894,20,60,40,20,0,-20,20,1,10,60
30,22,22,3273,20,50,30,20,0,-10,10,0,10,40
30,23,23,2763,10,40,30,10,0,-10,10,1,10,40
30,24,24,3479,20,80,60,20,0,0,0,-0.5,10,60
30,25,25,2477,-20,20,40,20,0,0,0,0.5,-10,40
30,26,26,2584,0,30,30,0,0,-10,10,,,40
30,27,27,2636,-10,40,50,10,0,-10,10,-1,-10,60
30,28,28,3128,-10,50,60,10,0,0,0,,-10,60
30,29,29,3268,30,60,30,30,0,-10,10,,30,40
30,30,0,3397,-10,40,50,10,1,10,10,1,-10,40
30,31,1,2737,20,80,60,20,1,0,0,0.5,10,60
30,32,2,2545,-40,0,40,40,1,0,0,0.5,-50,40
30,33,3,2667,30,100,70,30,1,10,10,-0.333333333,30,60
30,34,4,3174,40,60,20,40,1,-20,20,0,50,40
30,35,5,3446,60,80,20,60,1,-20,20,0.833333333,50,40
30,36,6,2605,0,60,60,0,1,0,0,,,60
30,37,7,2513,0,40,40,0,1,-20,20,,,60
30,38,8,2734,-50,20,70,50,1,30,30,0.2,-50,40
30,39,9,3209,-10,20,30,10,1,-30,30,-1,-10,60
30,40,10,2606,20,60,40,20,1,-20,20,1.5,10,60
30,41,11,2685,-60,0,60,60,1,20,20,0,-50,40
30,42,12,3914,-20,40,60,20,1,20,20,0.5,-10,40
30,43,13,3643,-30,40,70,30,1,10,10,0.333333333,-30,60
30,44,14,2703,10,60,50,10,1,10,10,2,10,40
30,45,15,3523,-40,20,60,40,1,0,0,0.75,-50,60
30,46,16,3578,-50,20,70,50,1,30,30,0.4,-50,40
30,47,17,3523,70,100,30,70,1,-30,30,0.428571429,70,60
30,48,18,4098,20,80,60,20,1,0,0,-2,10,60
30,49,19,3812,30,80,50,30,1,10,10,1,30,40
30,50,20,3086,-80,0,80,80,1,40,40,0.25,-70,40
30,51,21,2622,20,40,20,20,1,-40,40,0.5,10,60
30,52,22,3417,30,60,30,30,1,-30,30,0.666666667,30,60
30,53,23,3948,-40,20,60,40,1,20,20,-0.25,-50,40
30,54,24,3518,30,80,50,30,1,-10,10,-1,30,60
30,55,25,2795,-30,40,70,30,1,30,30,0,-30,40
30,56,26,2592,80,100,20,80,1,-40,40,0.5,70,60
30,57,27,4536,-10,60,70,10,1,30,30,-1,-10,40
30,58,28,4113,0,80,80,0,1,40,40,,,40
30,59,29,2898,-40,20,60,40,1,0,0,,-50,60
31,0,0,6798,-30,60,90,30,1,50,50,0,-30,40
31,1,1,5675,40,60,20,40,1,-40,40,1.75,50,60
31,2,2,3047,-90,0,90,90,1,50,50,0.777777778,-70,40
31,3,3,3421,-10,80,90,10,1,30,30,0,-10,60
31,4,4,4508,0,20,20,0,1,-20,20,,,40
31,5,5,3106,60,80,20,60,1,-20,20,0.333333333,50,40
31,6,6,3962,10,100,90,10,1,30,30,1,10,60
31,7,7,7001,-60,40,100,60,1,40,40,0,-50,60
31,8,8,4323,0,40,40,0,1,0,0,,,40
31,9,9,3933,-80,20,100,80,1,40,40,0.375,-70,60
31,10,10,5382,-10,60,70,10,1,10,10,-3,-10,60
31,11,11,3546,50,60,10,50,1,-30,30,1.8,50,40
31,12,12,4042,-80,20,100,80,1,60,60,0.75,-70,40
31,13,13,3774,-20,80,100,20,1,40,40,0,-10,60
31,14,14,4670,0,40,40,0,1,0,0,,,40
31,15,15,3786,-60,40,100,60,1,40,40,0.333333333,-50,60
31,16,16,3342,40,80,40,40,1,0,0,-0.5,50,40
31,17,17,3507,-60,20,80,60,1,20,20,0,-50,60
31,18,18,3485,20,100,80,20,1,20,20,0,10,60
31,19,19,3605,-20,0,20,20,1,-20,20,0.5,-10,40
31,20,20,5046,50,60,10,50,1,-30,30,0.6,50,40
31,21,21,3869,0,80,80,0,1,20,20,,,60
31,22,22,3838,-60,20,80,60,1,20,20,-0.333333333,-50,60
31,23,23,4243,-40,0,40,40,1,0,0,-0.5,-50,40
31,24,24,3398,-60,40,100,60,1,40,40,0.333333333,-50,60
31,25,25,4198,-20,40,60,20,1,20,20,0.5,-10,40
31,26,26,5995,-20,60,80,20,1,20,20,0,-10,60
31,27,27,3848,-30,20,50,30,1,10,10,1.666666667,-30,40
31,28,28,6781,80,80,0,80,1,-40,40,,70,40
31,29,29,4679,20,100,80,20,1,20,20,,10,60
31,30,0,5436,-60,40,100,60,0,40,40,0.666666667,-50,60
31,31,1,3635,10,50,40,10,0,0,0,1,10,40
31,32,2,3886,-30,20,50,30,0,10,10,0.333333333,-30,40
31,33,3,4760,20,80,60,20,0,0,0,0.5,10,60
31,34,4,3593,-10,60,70,10,0,10,10,-1,-10,60
31,35,5,3269,0,40,40,0,0,0,0,,,40
31,36,6,2836,10,60,50,10,0,10,10,-1,10,40
31,37,7,4351,-10,70,80,10,0,20,20,3,-10,60
31,38,8,2990,-10,30,40,10,0,0,0,0,-10,40
31,39,9,4148,0,50,50,0,0,-10,10,,,60
31,40,10,3383,-20,20,40,20,0,0,0,0,-10,40
31,41,11,2864,50,70,20,50,0,-40,40,1.2,50,60
31,42,12,3123,-40,40,80,40,0,20,20,0.5,-50,60
31,43,13,3621,20,60,40,20,0,0,0,0,10,40
31,44,14,3795,20,80,60,20,0,0,0,0,10,60
31,45,15,3468,10,50,40,10,0,0,0,0,10,40
31,46,16,5729,-10,50,60,10,0,0,0,0,-10,60
31,47,17,3563,-10,30,40,10,0,0,0,0,-10,40
31,48,18,3082,0,60,60,0,0,0,0,,,60
31,49,19,3467,0,40,40,0,0,0,0,,,40
31,50,20,2786,10,80,70,10,0,10,10,1,10,60
31,51,21,4136,-40,40,80,40,0,20,20,0.5,-50,60
31,52,22,3413,-20,20,40,20,0,0,0,0,-10,40
31,53,23,3865,0,40,40,0,0,0,0,,,40
31,54,24,3767,10,70,60,10,0,0,0,0,10,60
31,55,25,4986,10,50,40,10,0,0,0,0,10,40
31,56,26,4214,20,60,40,20,0,0,0,0.5,10,40
31,57,27,4248,0,60,60,0,0,0,0,,,60
31,58,28,3563,10,50,40,10,0,-20,20,,10,60
31,59,29,2866,-20,30,50,20,0,10,10,,-10,40
32,0,0,5689,-20,50,70,20,0,10,10,2.5,-10,60
32,1,1,4822,30,50,20,30,0,-20,20,0,30,40
32,2,2,4896,40,60,20,40,0,-20,20,0,50,40
32,3,3,4658,20,40,20,20,0,-40,40,0,10,60
32,4,4,4757,40,60,20,40,0,-40,40,0.75,50,60
32,5,5,4765,20,40,20,20,0,-20,20,3,10,40
32,6,6,6907,-50,30,80,50,0,40,40,1,-50,40
32,7,7,3872,20,70,50,20,0,-10,10,0,10,60
32,8,8,4550,-10,20,30,10,0,-10,10,1,-10,40
32,9,9,3682,30,80,50,30,0,-10,10,1,30,60
32,10,10,3592,10,30,20,10,0,-20,20,0,10,40
32,11,11,3945,-10,70,80,10,0,20,20,3,-10,60
32,12,12,6877,-10,40,50,10,0,-10,10,-2,-10,60
32,13,13,3912,30,50,20,30,0,-20,20,0.333333333,30,40
32,14,14,3920,10,80,70,10,0,10,10,0,10,60
32,15,15,3725,30,60,30,30,0,-10,10,0,30,40
32,16,16,3663,-10,60,70,10,0,10,10,-0.5,-10,60
32,17,17,3500,10,40,30,10,0,-10,10,1,10,40
32,18,18,3772,-25,50,75,25,0,15,15,-0.2,-30,60
32,19,19,3634,-20,20,40,20,0,0,0,0,-10,40
32,20,20,3561,0,80,80,0,0,20,20,,,60
32,21,21,3757,-20,50,70,20,0,10,10,-0.5,-10,60
32,22,22,3814,10,50,40,10,0,0,0,0,10,40
32,23,23,3718,0,40,40,0,0,0,0,,,40
32,24,24,4821,-10,70,80,10,0,20,20,0,-10,60
32,25,25,3899,0,30,30,0,0,-10,10,,,40
32,26,26,4100,-20,20,40,20,0,0,0,0,-10,40
32,27,27,4677,-20,60,80,20,0,20,20,0,-10,60
32,28,28,3906,-40,40,80,40,0,20,20,,-50,60
32,29,29,4062,20,60,40,20,0,0,0,,10,40
32,30,0,5169,-40,20,60,40,1,20,20,0.5,-50,40
32,31,1,4119,-10,60,70,10,1,10,10,0,-10,60
32,32,2,4019,0,40,40,0,1,0,0,,,40
32,33,3,3905,30,100,70,30,1,10,10,0,30,60
32,34,4,3741,40,80,40,40,1,0,0,0.25,50,40
32,35,5,3910,-50,0,50,50,1,10,10,0.4,-50,40
32,36,6,4315,-50,20,70,50,1,10,10,0,-50,60
32,37,7,4053,10,80,70,10,1,10,10,1,10,60
32,38,8,3761,30,60,30,30,1,-10,10,1,30,40
32,39,9,4699,-40,40,80,40,1,20,20,0,-50,60
32,40,10,4207,20,100,80,20,1,20,20,0,10,60
32,41,11,4540,-60,0,60,60,1,20,20,0.333333333,-50,40
32,42,12,3845,20,60,40,20,1,0,0,0,10,40
32,43,13,3955,-60,20,80,60,1,20,20,0,-50,60
32,44,14,4060,0,40,40,0,1,0,0,,,40
32,45,15,3935,-40,40,80,40,1,20,20,0,-50,60
32,46,16,3816,40,80,40,40,1,0,0,0.5,50,40
32,47,17,4051,-20,60,80,20,1,20,20,-1,-10,60
32,48,18,4122,-20,80,100,20,1,40,40,0,-10,60
32,49,19,3982,-40,20,60,40,1,20,20,0,-50,40
32,50,20,4792,-20,40,60,20,1,20,20,0,-10,40
32,51,21,4079,0,100,100,0,1,40,40,,,60
32,52,22,5464,-60,40,100,60,1,40,40,0,-50,60
32,53,23,3992,0,60,60,0,1,20,20,,,40
32,54,24,3935,-80,20,100,80,1,40,40,0,-70,60
32,55,25,4277,-40,20,60,40,1,20,20,0,-50,40
32,56,26,4146,-40,60,100,40,1,40,40,0,-50,60
32,57,27,3838,-60,0,60,60,1,20,20,0,-50,40
32,58,28,4185,20,80,60,20,1,20,20,,10,40
32,59,29,4056,-20,80,100,20,1,40,40,,-10,60
33,0,0,4847,-50,20,70,50,1,30,30,1,-50,40
33,1,1,4592,30,100,70,30,1,10,10,-1.666666667,30,60
33,2,2,4505,60,80,20,60,1,-20,20,1.166666667,50,40
33,3,3,6986,60,80,20,60,1,-40,40,0.333333333,50,60
33,4,4,5346,-50,40,90,50,1,50,50,0.8,-50,40
33,5,5,6885,-50,0,50,50,1,10,10,-0.4,-50,40
33,6,6,4113,-20,20,40,20,1,-20,20,-0.5,-10,60
33,7,7,4173,10,60,50,10,1,-10,10,-2,10,60
33,8,8,4260,-10,60,70,10,1,30,30,3,-10,40
33,9,9,4965,10,40,30,10,1,-30,30,-1,10,60
33,10,10,3985,60,80,20,60,1,-40,40,1,50,60
33,11,11,4730,20,60,40,20,1,0,0,1,10,40
33,12,12,4245,20,80,60,20,1,20,20,0,10,40
33,13,13,3942,-20,60,80,20,1,20,20,2,-10,60
33,14,14,4609,-40,20,60,40,1,20,20,0,-50,40
33,15,15,4605,60,100,40,60,1,-20,20,0,50,60
33,16,16,5016,-60,0,60,60,1,20,20,0,-50,40
33,17,17,4289,0,40,40,0,1,-20,20,,,60
33,18,18,4421,-60,20,80,60,1,20,20,0.333333333,-50,60
33,19,19,4033,-20,40,60,20,1,20,20,1,-10,40
33,20,20,3917,-20,20,40,20,1,0,0,-2,-10,40
33,21,21,4461,20,80,60,20,1,0,0,-1,10,60
33,22,22,4293,0,40,40,0,1,-20,20,,,60
33,23,23,4365,-40,40,80,40,1,40,40,0,-50,40
33,24,24,4534,60,100,40,60,1,-20,20,0.333333333,50,60
33,25,25,4377,-20,60,80,20,1,40,40,1,-10,40
33,26,26,4109,-40,20,60,40,1,0,0,0,-50,60
33,27,27,4433,-60,0,60,60,1,20,20,0.333333333,-50,40
33,28,28,3853,40,80,40,40,1,0,0,,50,40
33,29,29,4216,0,60,60,0,1,0,0,,,60
33,30,0,4583,-20,40,60,20,0,0,0,0,-10,60
33,31,1,4168,-40,20,60,40,0,20,20,0.5,-50,40
33,32,2,4385,0,40,40,0,0,0,0,,,40
33,33,3,4241,0,60,60,0,0,0,0,,,60
33,34,4,3857,10,70,60,10,0,0,0,1,10,60
33,35,5,4389,10,50,40,10,0,0,0,1,10,40
33,36,6,4101,-20,30,50,20,0,10,10,0,-10,40
33,37,7,3889,-20,50,70,20,0,10,10,2,-10,60
33,38,8,3842,10,60,50,10,0,10,10,-2,10,40
33,39,9,3938,50,80,30,50,0,-30,30,-0.2,50,60
33,40,10,5149,20,50,30,20,0,-10,10,-0.5,10,40
33,41,11,4245,40,60,20,40,0,-40,40,0.75,50,60
33,42,12,4221,20,70,50,20,0,-10,10,0.5,10,60
33,43,13,4429,10,30,20,10,0,-20,20,2,10,40
33,44,14,3973,-10,50,60,10,0,0,0,-1,-10,60
33,45,15,4741,20,60,40,20,0,0,0,-0.5,10,40
33,46,16,4092,10,80,70,10,0,10,10,-3,10,60
33,47,17,4074,-10,20,30,10,0,-10,10,0,-10,40
33,48,18,4643,0,40,40,0,0,-20,20,,,60
33,49,19,4376,10,40,30,10,0,-10,10,-1,10,40
33,50,20,4532,10,80,70,10,0,10,10,-4,10,60
33,51,21,4100,10,40,30,10,0,-30,30,7,10,60
33,52,22,4125,20,40,20,20,0,-20,20,1,10,40
33,53,23,4397,20,60,40,20,0,0,0,0,10,40
33,54,24,4256,-50,50,100,50,0,40,40,1.6,-50,60
33,55,25,4680,-20,20,40,20,0,0,0,0,-10,40
33,56,26,4777,10,50,40,10,0,0,0,-1,10,40
33,57,27,4252,40,60,20,40,0,-40,40,0.75,50,60
33,58,28,4669,20,70,50,20,0,-10,10,,10,60
33,59,29,4105,0,30,30,0,0,-10,10,,,40
34,0,0,4084,20,80,60,20,0,0,0,1,10,60
34,1,1,2538,0,30,30,0,0,-10,10,,,40
34,2,2,2802,20,50,30,20,0,-10,10,1,10,40
34,3,3,2458,-40,40,80,40,0,20,20,0.5,-50,60
34,4,4,2506,10,70,60,10,0,0,0,-6,10,60
34,5,5,2504,-30,20,50,30,0,10,10,0.666666667,-30,40
34,6,6,2786,10,40,30,10,0,-10,10,-1,10,40
34,7,7,2218,50,50,0,50,0,-60,60,1,50,60
34,8,8,3353,40,60,20,40,0,-20,20,0.5,50,40
34,9,9,2522,10,60,50,10,0,-10,10,2,10,60
34,10,10,2546,20,60,40,20,0,0,0,-1,10,40
34,11,11,2522,0,70,70,0,0,10,10,,,60
34,12,12,2618,0,60,60,0,0,0,0,,,60
34,13,13,2586,10,30,20,10,0,-20,20,3,10,40
34,14,14,2860,20,80,60,20,0,0,0,0,10,60
34,15,15,2658,0,50,50,0,0,10,10,,,40
34,16,16,2955,-10,50,60,10,0,0,0,-1,-10,60
34,17,17,2518,0,40,40,0,0,0,0,,,40
34,18,18,2595,-30,40,70,30,0,10,10,-0.333333333,-30,60
34,19,19,2620,0,20,20,0,0,-20,20,,,40
34,20,20,2571,-40,40,80,40,0,20,20,0.25,-50,60
34,21,21,2617,-20,50,70,20,0,10,10,0.5,-10,60
34,22,22,2594,0,20,20,0,0,-20,20,,,40
34,23,23,3395,10,30,20,10,0,-20,20,1,10,40
34,24,24,2649,10,70,60,10,0,0,0,0,10,60
34,25,25,2640,10,40,30,10,0,-10,10,2,10,40
34,26,26,2898,0,50,50,0,0,10,10,,,40
34,27,27,3202,0,60,60,0,0,0,0,,,60
34,28,28,2811,40,80,40,40,0,-20,20,,50,60
34,29,29,2451,20,60,40,20,0,0,0,,10,40
34,30,0,3160,-10,20,30,10,1,-10,10,1,-10,40
34,31,1,2512,20,100,80,20,1,20,20,0.5,10,60
34,32,2,2506,60,80,20,60,1,-20,20,0.666666667,50,40
34,33,3,2632,-30,60,90,30,1,30,30,1,-30,60
34,34,4,2650,0,60,60,0,1,20,20,,,40
34,35,5,2530,-10,40,50,10,1,10,10,1,-10,40
34,36,6,2899,20,80,60,20,1,0,0,0.5,10,60
34,37,7,2531,-50,20,70,50,1,10,10,0,-50,60
34,38,8,2533,-40,0,40,40,1,0,0,0,-50,40
34,39,9,2683,-30,40,70,30,1,10,10,-0.333333333,-30,60
34,40,10,3088,-60,20,80,60,1,20,20,0.833333333,-50,60
34,41,11,2626,0,40,40,0,1,0,0,,,40
34,42,12,3343,20,80,60,20,1,20,20,0,10,40
34,43,13,2700,30,60,30,30,1,-30,30,2,30,60
34,44,14,2761,-40,20,60,40,1,20,20,0.5,-50,40
34,45,15,2706,-10,80,90,10,1,30,30,-1,-10,60
34,46,16,3769,-40,0,40,40,1,0,0,0.25,-50,40
34,47,17,2714,0,100,100,0,1,40,40,,,60
34,48,18,2951,30,40,10,30,1,-50,50,1.333333333,30,60
34,49,19,2674,30,60,30,30,1,-10,10,0,30,40
34,50,20,2538,-30,0,30,30,1,-10,10,0,-30,40
34,51,21,3298,-30,20,50,30,1,-10,10,-0.666666667,-30,60
34,52,22,2612,10,80,70,10,1,10,10,-1,10,60
34,53,23,2605,30,60,30,30,1,-10,10,0.333333333,30,40
34,54,24,3525,40,100,60,40,1,0,0,-1,50,60
34,55,25,2500,0,40,40,0,1,0,0,,,40
34,56,26,2729,20,40,20,20,1,-40,40,1.5,10,60
34,57,27,2608,10,20,10,10,1,-30,30,0,10,40
34,58,28,2569,70,80,10,70,1,-30,30,,70,40
34,59,29,2555,10,60,50,10,1,-10,10,,10,60
35,0,0,3710,0,60,60,0,0,0,0,,,60
35,1,1,5033,-10,30,40,10,0,0,0,-1,-10,40
35,2,2,4974,-10,40,50,10,0,10,10,1,-10,40
35,3,3,5328,10,70,60,10,0,0,0,0,10,60
35,4,4,4425,-20,40,60,20,0,0,0,0.5,-10,60
35,5,5,5424,10,50,40,10,0,0,0,0,10,40
35,6,6,4091,-20,20,40,20,0,0,0,0,-10,40
35,7,7,4592,30,80,50,30,0,-10,10,1,30,60
35,8,8,4190,20,60,40,20,0,0,0,0.5,10,40
35,9,9,4521,-30,50,80,30,0,20,20,0,-30,60
35,10,10,5032,-10,40,50,10,0,10,10,1,-10,40
35,11,11,3409,-30,50,80,30,0,20,20,0.666666667,-30,60
35,12,12,4616,20,80,60,20,0,0,0,-0.5,10,60
35,13,13,3921,-10,30,40,10,0,0,0,0,-10,40
35,14,14,4743,10,60,50,10,0,-10,10,1,10,60
35,15,15,4256,20,60,40,20,0,0,0,0,10,40
35,16,16,4933,-20,40,60,20,0,0,0,0,-10,60
35,17,17,3729,10,50,40,10,0,0,0,2,10,40
35,18,18,4718,10,70,60,10,0,0,0,1,10,60
35,19,19,6148,-40,20,60,40,0,20,20,0.75,-50,40
35,20,20,3045,-10,60,70,10,0,10,10,1,-10,60
35,21,21,4583,-20,40,60,20,0,0,0,0,-10,60
35,22,22,3532,30,60,30,30,0,-10,10,0,30,40
35,23,23,3946,20,50,30,20,0,-10,10,0,10,40
35,24,24,4320,20,80,60,20,0,0,0,-0.5,10,60
35,25,25,4656,-10,20,30,10,0,-10,10,0,-10,40
35,26,26,4256,10,40,30,10,0,-10,10,2,10,40
35,27,27,4588,20,70,50,20,0,-10,10,1,10,60
35,28,28,3467,-20,50,70,20,0,10,10,,-10,60
35,29,29,4067,-20,30,50,20,0,10,10,,-10,40
35,30,0,3771,-60,0,60,60,1,20,20,0.666666667,-50,40
35,31,1,3611,10,60,50,10,1,-10,10,-1,10,60
35,32,2,4646,20,40,20,20,1,-20,20,0,10,40
35,33,3,4131,60,100,40,60,1,-20,20,0.666666667,50,60
35,34,4,3490,60,80,20,60,1,-20,20,0.166666667,50,40
35,35,5,3738,30,60,30,30,1,-10,10,0,30,40
35,36,6,4719,0,80,80,0,1,20,20,,,60
35,37,7,4653,-50,20,70,50,1,10,10,0.8,-50,60
35,38,8,4590,-10,20,30,10,1,-10,10,-3,-10,40
35,39,9,4759,10,40,30,10,1,-30,30,1,10,60
35,40,10,4171,20,60,40,20,1,-20,20,1,10,60
35,41,11,3575,-20,40,60,20,1,20,20,2,-10,40
35,42,12,4023,60,80,20,60,1,-20,20,0,50,40
35,43,13,2993,-40,20,60,40,1,0,0,0,-50,60
35,44,14,3197,0,20,20,0,1,-20,20,,,40
35,45,15,4367,20,80,60,20,1,0,0,0,10,60
35,46,16,4877,10,60,50,10,1,10,10,-3,10,40
35,47,17,4316,40,100,60,40,1,0,0,-0.25,50,60
35,48,18,3068,-10,40,50,10,1,-10,10,-1,-10,60
35,49,19,5393,-20,0,20,20,1,-20,20,-1,-10,40
35,50,20,4128,-40,0,40,40,1,0,0,0.5,-50,40
35,51,21,3303,40,100,60,40,1,0,0,0.25,50,60
35,52,22,2760,-10,60,70,10,1,10,10,0,-10,60
35,53,23,3094,0,20,20,0,1,-20,20,,,40
35,54,24,3853,-30,40,70,30,1,10,10,1,-30,60
35,55,25,2959,30,60,30,30,1,-10,10,1,30,40
35,56,26,3846,-20,20,40,20,1,-20,20,-0.5,-10,60
35,57,27,4250,20,80,60,20,1,20,20,1,10,40
35,58,28,4184,-40,40,80,40,1,40,40,,-50,40
35,59,29,5687,30,80,50,30,1,-10,10,,30,60
36,0,0,6267,-60,40,100,60,1,60,60,0.333333333,-50,40
36,1,1,4389,20,100,80,20,1,20,20,1,10,60
36,2,2,3978,0,80,80,0,1,40,40,,,40
36,3,3,4326,-60,40,100,60,1,40,40,1.333333333,-50,60
36,4,4,4713,-10,20,30,10,1,-10,10,-3,-10,40
36,5,5,4303,0,60,60,0,1,20,20,,,40
36,6,6,4569,0,20,20,0,1,-40,40,,,60
36,7,7,4940,-30,60,90,30,1,30,30,1.666666667,-30,60
36,8,8,4648,-100,0,100,100,1,60,60,0.8,-70,40
36,9,9,4318,40,80,40,40,1,-20,20,0,50,60
36,10,10,4577,0,40,40,0,1,-20,20,,,60
36,11,11,5910,40,60,20,40,1,-20,20,1.75,50,40
36,12,12,3970,-10,80,90,10,1,50,50,8,-10,40
36,13,13,6544,0,20,20,0,1,-40,40,,,60
36,14,14,4825,10,20,10,10,1,-30,30,1,10,40
36,15,15,4669,0,100,100,0,1,40,40,,,60
36,16,16,4175,-20,0,20,20,1,-20,20,-4,-10,40
36,17,17,3985,60,60,0,60,1,-60,60,0.666666667,50,60
36,18,18,4248,40,80,40,40,1,-20,20,0,50,60
36,19,19,4945,-60,40,100,60,1,60,60,0,-50,40
36,20,20,4321,-80,20,100,80,1,60,60,,-70,40
36,21,21,4313,40,80,40,40,1,-20,20,-0.5,50,60
36,22,22,5919,40,60,20,40,1,-40,40,1,50,60
36,23,23,7002,,40,,,1,,,,,40
36,24,24,5590,-40,20,60,40,1,0,0,0,-50,60
36,25,25,3943,40,60,20,40,1,-20,20,0,50,40
36,26,26,3840,-20,40,60,20,1,0,0,1,-10,60
36,27,27,4027,-20,0,20,20,1,-20,20,-1.5,-10,40
36,28,28,3901,30,80,50,30,1,10,10,,30,40
36,29,29,4208,60,100,40,60,1,-20,20,,50,60
36,30,0,5729,20,60,40,20,0,-20,20,0,10,60
36,31,1,6368,10,30,20,10,0,-20,20,0,10,40
36,32,2,3699,20,40,20,20,0,-20,20,0,10,40
36,33,3,5205,40,80,40,40,0,-20,20,,50,60
36,34,4,7002,,40,,,0,,,,,60
36,35,5,7003,30,50,20,30,0,-20,20,0,30,40
36,36,6,4862,0,20,20,0,0,-20,20,,,40
36,37,7,4055,-10,50,60,10,0,0,0,-2,-10,60
36,38,8,3992,-40,60,100,40,0,60,60,0,-50,40
36,39,9,4487,-10,70,80,10,0,20,20,-2,-10,60
36,40,10,4599,-60,40,100,60,0,60,60,1.333333333,-50,40
36,41,11,4335,-20,80,100,20,0,40,40,4,-10,60
36,42,12,4429,40,60,20,40,0,-40,40,2,50,60
36,43,13,5263,40,60,20,40,0,-20,20,2,50,40
36,44,14,3752,-60,40,100,60,0,40,40,1.166666667,-50,60
36,45,15,4543,-70,30,100,70,0,60,60,1.142857143,-70,40
36,46,16,3838,20,50,30,20,0,-30,30,1.5,10,60
36,47,17,4072,0,20,20,0,0,-20,20,,,40
36,48,18,4225,10,70,60,10,0,0,0,-4,10,60
36,49,19,4080,10,50,40,10,0,0,0,6,10,40
36,50,20,4999,50,70,20,50,0,-40,40,1.6,50,60
36,51,21,3680,-20,80,100,20,0,40,40,4,-10,60
36,52,22,4607,-50,50,100,50,0,60,60,1.4,-50,40
36,53,23,3759,10,40,30,10,0,-10,10,7,10,40
36,54,24,3648,30,50,20,30,0,-40,40,2.666666667,30,60
36,55,25,4577,-40,60,100,40,0,60,60,1.5,-50,40
36,56,26,4535,-20,20,40,20,0,0,0,0,-10,40
36,57,27,4280,-60,40,100,60,0,40,40,0.666666667,-50,60
36,58,28,3974,0,60,60,0,0,0,0,,,60
36,59,29,4218,-10,30,40,10,0,0,0,,-10,40
37,0,0,4958,-30,70,100,30,0,40,40,0.333333333,-30,60
37,1,1,4421,0,40,40,0,0,0,0,,,40
37,2,2,4718,40,60,20,40,0,-20,20,1.75,50,40
37,3,3,5815,-40,50,90,40,0,30,30,1.75,-50,60
37,4,4,5495,40,60,20,40,0,-40,40,1,50,60
37,5,5,4134,-70,20,90,70,0,50,50,0.571428571,-70,40
37,6,6,4664,-20,30,50,20,0,10,10,1.5,-10,40
37,7,7,3943,20,80,60,20,0,0,0,0,10,60
37,8,8,4174,30,50,20,30,0,-20,20,0.666666667,30,40
37,9,9,4832,-20,40,60,20,0,0,0,0.5,-10,60
37,10,10,4444,20,60,40,20,0,0,0,-2,10,40
37,11,11,4653,30,80,50,30,0,-10,10,1,30,60
37,12,12,5174,-40,40,80,40,0,20,20,0,-50,60
37,13,13,4462,50,50,0,50,0,-40,40,1,50,40
37,14,14,4127,-10,70,80,10,0,20,20,2,-10,60
37,15,15,4791,-30,20,50,30,0,10,10,-0.666666667,-30,40
37,16,16,6492,0,60,60,0,0,0,0,,,60
37,17,17,5214,-40,30,70,40,0,30,30,1.25,-50,40
37,18,18,4254,-10,50,60,10,0,0,0,4,-10,60
37,19,19,4713,20,40,20,20,0,-20,20,0,10,40
37,20,20,4862,20,40,20,20,0,-40,40,1.5,10,60
37,21,21,4535,20,70,50,20,0,-10,10,-1.5,10,60
37,22,22,3713,40,60,20,40,0,-20,20,1,50,40
37,23,23,4485,-10,50,60,10,0,20,20,4,-10,40
37,24,24,4302,40,60,20,40,0,-40,40,0.5,50,60
37,25,25,4458,10,30,20,10,0,-20,20,4,10,40
37,26,26,4791,-20,40,60,20,0,20,20,0.5,-10,40
37,27,27,5936,40,80,40,40,0,-20,20,-0.5,50,60
37,28,28,4366,30,50,20,30,0,-40,40,,30,60
37,29,29,4190,-30,20,50,30,0,10,10,,-30,40
37,30,0,4760,20,40,20,20,1,-20,20,0.5,10,40
37,31,1,5770,-40,60,100,40,1,40,40,0,-50,60
37,32,2,3712,-30,0,30,30,1,-10,10,-1,-30,40
37,33,3,3929,-60,40,100,60,1,40,40,1,-50,60
37,34,4,4029,0,60,60,0,1,20,20,,,40
37,35,5,4464,40,80,40,40,1,0,0,0.25,50,40
37,36,6,6362,40,80,40,40,1,-20,20,1.5,50,60
37,37,7,4852,0,100,100,0,1,40,40,,,60
37,38,8,4380,-30,20,50,30,1,10,10,1,-30,40
37,39,9,3596,0,20,20,0,1,-40,40,,,60
37,40,10,4772,30,100,70,30,1,10,10,0,30,60
37,41,11,4312,40,60,20,40,1,-20,20,1.5,50,40
37,42,12,4246,0,80,80,0,1,40,40,,,40
37,43,13,4959,-30,40,70,30,1,10,10,1.666666667,-30,60
37,44,14,5308,-50,0,50,50,1,10,10,0.6,-50,40
37,45,15,3718,40,60,20,40,1,-40,40,2,50,60
37,46,16,4268,0,20,20,0,1,-20,20,,,40
37,47,17,5470,-80,20,100,80,1,40,40,0.75,-70,60
37,48,18,4047,40,80,40,40,1,-20,20,0,50,60
37,49,19,4404,10,40,30,10,1,-10,10,7,10,40
37,50,20,4040,-20,80,100,20,1,60,60,2.5,-10,40
37,51,21,3926,-20,20,40,20,1,-20,20,1,-10,60
37,52,22,3750,40,60,20,40,1,-40,40,-0.25,50,60
37,53,23,3966,-10,40,50,10,1,10,10,-4,-10,40
37,54,24,4138,90,100,10,90,1,-50,50,0.777777778,70,60
37,55,25,4900,-90,0,90,90,1,50,50,0.666666667,-70,40
37,56,26,3775,-40,40,80,40,1,20,20,1,-50,60
37,57,27,4013,-10,20,30,10,1,-10,10,1,-10,40
37,58,28,3592,40,60,20,40,1,-20,20,,50,40
37,59,29,4686,40,80,40,40,1,-20,20,,50,60
38,0,0,4946,-40,40,80,40,0,20,20,0.5,-50,60
38,1,1,3495,-10,40,50,10,0,10,10,2,-10,40
38,2,2,3206,-10,20,30,10,0,-10,10,-3,-10,40
38,3,3,4262,0,60,60,0,0,0,0,,,60
38,4,4,4497,40,80,40,40,0,-20,20,1.5,50,60
38,5,5,4054,-30,30,60,30,0,20,20,-0.333333333,-30,40
38,6,6,5512,-20,50,70,20,0,30,30,-0.5,-10,40
38,7,7,4044,-30,70,100,30,0,40,40,1,-30,60
38,8,8,4241,-20,60,80,20,0,40,40,2.5,-10,40
38,9,9,4070,-20,50,70,20,0,10,10,0.5,-10,60
38,10,10,4173,0,30,30,0,0,-10,10,,,40
38,11,11,3935,20,80,60,20,0,0,0,1,10,60
38,12,12,4957,-40,40,80,40,0,20,20,0,-50,60
38,13,13,4165,20,60,40,20,0,0,0,0,10,40
38,14,14,3936,-30,50,80,30,0,20,20,0.666666667,-30,60
38,15,15,4505,10,50,40,10,0,0,0,-1,10,40
38,16,16,4327,10,70,60,10,0,0,0,-1,10,60
38,17,17,4055,-10,20,30,10,0,-10,10,-3,-10,40
38,18,18,4254,10,60,50,10,0,-10,10,2,10,60
38,19,19,4510,-20,40,60,20,0,20,20,1.5,-10,40
38,20,20,4101,-30,40,70,30,0,10,10,-0.333333333,-30,60
38,21,21,4174,-30,50,80,30,0,20,20,1.333333333,-30,60
38,22,22,4365,20,50,30,20,0,-10,10,0.5,10,40
38,23,23,4455,-10,30,40,10,0,0,0,1,-10,40
38,24,24,4514,20,60,40,20,0,-20,20,2.5,10,60
38,25,25,4098,-10,20,30,10,0,-10,10,-2,-10,40
38,26,26,4000,10,60,50,10,0,10,10,0,10,40
38,27,27,3729,-20,70,90,20,0,30,30,0.5,-10,60
38,28,28,4132,0,80,80,0,0,20,20,,,60
38,29,29,4185,-10,40,50,10,0,10,10,,-10,40
38,30,0,4803,-30,60,90,30,1,50,50,0.333333333,-30,40
38,31,1,4384,-10,40,50,10,1,-10,10,2,-10,60
38,32,2,4590,0,80,80,0,1,40,40,,,40
38,33,3,4579,50,80,30,50,1,-30,30,0.2,50,60
38,34,4,4273,-40,40,80,40,1,40,40,0.25,-50,40
38,35,5,4320,-70,0,70,70,1,30,30,0,-70,40
38,36,6,4126,60,100,40,60,1,-20,20,0.666666667,50,60
38,37,7,4338,-20,60,80,20,1,20,20,2,-10,60
38,38,8,4344,-50,20,70,50,1,30,30,-0.6,-50,40
38,39,9,4272,-20,20,40,20,1,-20,20,-3,-10,60
38,40,10,5436,-80,20,100,80,1,40,40,1,-70,60
38,41,11,4200,-40,60,100,40,1,60,60,1,-50,40
38,42,12,4019,20,80,60,20,1,20,20,-1,10,40
38,43,13,4166,80,100,20,80,1,-40,40,0,70,60
38,44,14,3986,0,40,40,0,1,0,0,,,40
38,45,15,4136,20,40,20,20,1,-40,40,2,10,60
38,46,16,4153,-80,0,80,80,1,40,40,0.375,-70,40
38,47,17,4057,20,80,60,20,1,0,0,0,10,60
38,48,18,4522,0,60,60,0,1,0,0,,,60
38,49,19,4373,-30,20,50,30,1,10,10,1,-30,40
38,50,20,4426,-20,0,20,20,1,-20,20,-1.5,-10,40
38,51,21,4316,-40,20,60,40,1,0,0,0.75,-50,60
38,52,22,4302,10,40,30,10,1,-30,30,3,10,60
38,53,23,4236,30,80,50,30,1,10,10,0,30,40
38,54,24,4614,40,100,60,40,1,0,0,0,50,60
38,55,25,4979,-30,20,50,30,1,10,10,1,-30,40
38,56,26,4618,20,80,60,20,1,0,0,0,10,60
38,57,27,4069,40,60,20,40,1,-20,20,0.5,50,40
38,58,28,4853,0,40,40,0,1,0,0,,,40
38,59,29,4900,0,60,60,0,1,0,0,,,60
39,0,0,4497,-10,60,70,10,0,10,10,1,-10,60
39,1,1,3502,-10,30,40,10,0,0,0,-1,-10,40
39,2,2,7002,0,50,50,0,0,10,10,,,40
39,3,3,3682,-10,50,60,10,0,0,0,-2,-10,60
39,4,4,3841,-40,40,80,40,0,20,20,0.5,-50,60
39,5,5,3192,-65,20,85,65,0,45,45,0.846153846,-70,40
39,6,6,4593,30,60,30,30,0,-10,10,0.333333333,30,40
39,7,7,3516,20,80,60,20,0,0,0,1,10,60
39,8,8,3717,0,40,40,0,0,0,0,,,40
39,9,9,3409,-10,70,80,10,0,20,20,0,-10,60
39,10,10,4451,-10,30,40,10,0,0,0,1,-10,40
39,11,11,3787,-10,70,80,10,0,20,20,0.5,-10,60
39,12,12,3385,-35,40,75,35,0,15,15,0.142857143,-30,60
39,13,13,3109,30,60,30,30,0,-10,10,0.333333333,30,40
39,14,14,4283,-20,50,70,20,0,10,10,0.5,-10,60
39,15,15,2924,0,40,40,0,0,0,0,,,40
39,16,16,3176,0,60,60,0,0,0,0,,,60
39,17,17,3520,-20,20,40,20,0,0,0,0.5,-10,40
39,18,18,2962,10,80,70,10,0,10,10,0,10,60
39,19,19,2895,20,50,30,20,0,-10,10,0,10,40
39,20,20,2912,-30,40,70,30,0,10,10,1.333333333,-30,60
39,21,21,2863,40,70,30,40,0,-30,30,1,50,60
39,22,22,3100,-10,20,30,10,0,-10,10,0,-10,40
39,23,23,3399,30,60,30,30,0,-10,10,0,30,40
39,24,24,3937,-20,50,70,20,0,10,10,0,-10,60
39,25,25,3113,0,30,30,0,0,-10,10,,,40
39,26,26,3568,10,50,40,10,0,0,0,-1,10,40
39,27,27,3373,10,80,70,10,0,10,10,-1,10,60
39,28,28,3051,0,60,60,0,0,0,0,,,60
39,29,29,3333,10,40,30,10,0,-10,10,,10,40
39,30,0,3866,-30,0,30,30,1,-10,10,0.666666667,-30,40
39,31,1,3602,-10,60,70,10,1,10,10,2,-10,60
39,32,2,4245,70,80,10,70,1,-30,30,0.285714286,70,40
39,33,3,3378,30,80,50,30,1,-10,10,-0.666666667,30,60
39,34,4,3992,10,40,30,10,1,-10,10,2,10,40
39,35,5,2868,-30,20,50,30,1,10,10,-0.333333333,-30,40
39,36,6,2728,10,40,30,10,1,-30,30,1,10,60
39,37,7,2593,-20,20,40,20,1,-20,20,0.5,-10,60
39,38,8,2758,0,60,60,0,1,20,20,,,40
39,39,9,2657,70,100,30,70,1,-30,30,0.142857143,70,60
39,40,10,3282,-20,20,40,20,1,-20,20,0,-10,60
39,41,11,2609,-40,40,80,40,1,40,40,1.25,-50,40
39,42,12,2648,50,80,30,50,1,-10,10,0.2,50,40
39,43,13,2737,40,80,40,40,1,-20,20,0.25,50,60
39,44,14,2978,-40,0,40,40,1,0,0,-0.5,-50,40
39,45,15,2637,10,60,50,10,1,-10,10,-2,10,60
39,46,16,3093,0,60,60,0,1,20,20,,,40
39,47,17,2832,10,40,30,10,1,-30,30,2,10,60
39,48,18,2886,50,100,50,50,1,-10,10,-0.2,50,60
39,49,19,2607,-10,20,30,10,1,-10,10,-2,-10,40
39,50,20,4264,-30,20,50,30,1,10,10,0.666666667,-30,40
39,51,21,2773,0,40,40,0,1,-20,20,,,60
39,52,22,3119,0,80,80,0,1,20,20,,,60
39,53,23,3232,50,80,30,50,1,-10,10,,50,40
39,54,24,2657,60,100,40,60,1,-20,20,0.666666667,50,60
39,55,25,3210,,60,,,1,,,,,40
39,56,26,3214,-60,20,80,60,1,20,20,1,-50,60
39,57,27,2617,-40,0,40,40,1,0,0,-0.75,-50,40
39,58,28,2714,-30,40,70,30,1,30,30,,-30,40
39,59,29,2497,40,60,20,40,1,-40,40,,50,60
40,0,0,4091,-30,50,80,30,0,20,20,1,-30,60
40,1,1,2943,-50,20,70,50,0,30,30,0.8,-50,40
40,2,2,2808,10,40,30,10,0,-10,10,0,10,40
40,3,3,2844,-10,40,50,10,0,-10,10,-2,-10,60
40,4,4,2848,0,70,70,0,0,10,10,,,60
40,5,5,5545,0,30,30,0,0,-10,10,,,40
40,6,6,2998,40,60,20,40,0,-20,20,0.5,50,40
40,7,7,2880,-30,60,90,30,0,30,30,1,-30,60
40,8,8,3615,10,50,40,10,0,0,0,0,10,40
40,9,9,6201,20,80,60,20,0,0,0,0.5,10,60
40,10,10,3105,10,50,40,10,0,0,0,1,10,40
40,11,11,3060,-10,60,70,10,0,10,10,0,-10,60
40,12,12,3374,-30,40,70,30,0,10,10,0,-30,60
40,13,13,2787,-20,30,50,20,0,10,10,1,-10,40
40,14,14,2897,10,80,70,10,0,10,10,-1,10,60
40,15,15,2752,30,60,30,30,0,-10,10,1,30,40
40,16,16,2800,10,70,60,10,0,0,0,0,10,60
40,17,17,2766,-40,20,60,40,0,20,20,1,-50,40
40,18,18,5321,-10,50,60,10,0,0,0,1,-10,60
40,19,19,3159,20,40,20,20,0,-20,20,1,10,40
40,20,20,2860,30,80,50,30,0,-10,10,0.333333333,30,60
40,21,21,2786,10,70,60,10,0,0,0,1,10,60
40,22,22,4003,20,60,40,20,0,0,0,-0.5,10,40
40,23,23,2824,-10,20,30,10,0,-10,10,-1,-10,40
40,24,24,3972,-20,50,70,20,0,10,10,0,-10,60
40,25,25,2712,-10,30,40,10,0,0,0,-1,-10,40
40,26,26,2692,-10,40,50,10,0,10,10,2,-10,40
40,27,27,4160,-30,40,70,30,0,10,10,1,-30,60
40,28,28,3271,20,60,40,20,0,-20,20,,10,60
40,29,29,2762,20,50,30,20,0,-10,10,,10,40
40,30,0,3269,-30,40,70,30,1,30,30,0.666666667,-30,40
40,31,1,3912,60,80,20,60,1,-40,40,0.666666667,50,60
40,32,2,2891,10,60,50,10,1,10,10,1,10,40
40,33,3,4059,-40,20,60,40,1,0,0,0.75,-50,60
40,34,4,3283,20,80,60,20,1,20,20,0.5,10,40
40,35,5,2931,-50,20,70,50,1,30,30,0.4,-50,40
40,36,6,2858,70,100,30,70,1,-30,30,0.285714286,70,60
40,37,7,3012,10,60,50,10,1,-10,10,1,10,60
40,38,8,3485,-50,0,50,50,1,10,10,0,-50,40
40,39,9,5603,-20,40,60,20,1,0,0,-0.5,-10,60
40,40,10,3421,-50,20,70,50,1,10,10,0.4,-50,60
40,41,11,3288,10,60,50,10,1,10,10,1,10,40
40,42,12,2850,-40,20,60,40,1,20,20,0.5,-50,40
40,43,13,4626,30,80,50,30,1,-10,10,0.666666667,30,60
40,44,14,2702,40,80,40,40,1,0,0,-0.25,50,40
40,45,15,3637,-30,40,70,30,1,10,10,0.333333333,-30,60
40,46,16,2989,-30,0,30,30,1,-10,10,-0.666666667,-30,40
40,47,17,3398,0,60,60,0,1,0,0,,,60
40,48,18,2825,60,100,40,60,1,-20,20,-0.333333333,50,60
40,49,19,3069,-10,40,50,10,1,10,10,1,-10,40
40,50,20,3519,-40,0,40,40,1,0,0,0,-50,40
40,51,21,3239,80,100,20,80,1,-40,40,0.625,70,60
40,52,22,5312,-10,60,70,10,1,10,10,1,-10,60
40,53,23,3682,20,60,40,20,1,0,0,0.5,10,40
40,54,24,4696,20,80,60,20,1,0,0,-1,10,60
40,55,25,3605,-10,40,50,10,1,10,10,-1,-10,40
40,56,26,3888,0,40,40,0,1,-20,20,,,60
40,57,27,3889,20,80,60,20,1,20,20,-0.5,10,40
40,58,28,4266,-30,20,50,30,1,10,10,,-30,40
40,59,29,4242,-50,20,70,50,1,10,10,,-50,60
41,0,0,4142,30,60,30,30,0,-30,30,2,30,60
41,1,1,4571,-40,20,60,40,0,20,20,0.5,-50,40
41,2,2,4092,20,60,40,20,0,0,0,-0.5,10,40
41,3,3,4245,-40,50,90,40,0,30,30,0.5,-50,60
41,4,4,4598,10,80,70,10,0,10,10,2,10,60
41,5,5,4240,10,40,30,10,0,-10,10,-1,10,40
41,6,6,3340,30,50,20,30,0,-20,20,1.666666667,30,40
41,7,7,2949,-20,70,90,20,0,30,30,2,-10,60
41,8,8,4424,-40,30,70,40,0,30,30,1,-50,40
41,9,9,4106,-10,40,50,10,0,-10,10,-2,-10,60
41,10,10,3003,0,30,30,0,0,-10,10,,,40
41,11,11,3316,-20,50,70,20,0,10,10,-0.5,-10,60
41,12,12,3286,0,80,80,0,0,20,20,,,60
41,13,13,4655,20,60,40,20,0,0,0,0,10,40
41,14,14,3414,-10,60,70,10,0,10,10,1,-10,60
41,15,15,3742,10,50,40,10,0,0,0,-1,10,40
41,16,16,3327,-20,40,60,20,0,0,0,-0.5,-10,60
41,17,17,3150,-10,20,30,10,0,-10,10,0,-10,40
41,18,18,2992,0,70,70,0,0,10,10,,,60
41,19,19,3185,10,40,30,10,0,-10,10,1,10,40
41,20,20,2861,-30,50,80,30,0,20,20,0.333333333,-30,60
41,21,21,3430,0,70,70,0,0,10,10,,,60
41,22,22,3567,10,50,40,10,0,0,0,-1,10,40
41,23,23,3210,-10,20,30,10,0,-10,10,-1,-10,40
41,24,24,3344,0,80,80,0,0,20,20,,,60
41,25,25,3315,0,40,40,0,0,0,0,,,40
41,26,26,3168,30,60,30,30,0,-10,10,0.333333333,30,40
41,27,27,3645,-20,40,60,20,0,0,0,0,-10,60
41,28,28,3194,0,60,60,0,0,0,0,,,60
41,29,29,2820,-10,30,40,10,0,0,0,,-10,40
41,30,0,3080,-60,0,60,60,1,20,20,0.666666667,-50,40
41,31,1,3155,10,80,70,10,1,10,10,-3,10,60
41,32,2,2984,40,60,20,40,1,-20,20,0.5,50,40
41,33,3,3334,20,60,40,20,1,-20,20,1.5,10,60
41,34,4,3128,0,40,40,0,1,0,0,,,40
41,35,5,4170,-40,20,60,40,1,20,20,0.75,-50,40
41,36,6,3524,-50,20,70,50,1,10,10,0.6,-50,60
41,37,7,3623,0,40,40,0,1,-20,20,,,60
41,38,8,3209,50,80,30,50,1,-10,10,-0.2,50,40
41,39,9,5006,60,100,40,60,1,-20,20,0.5,50,60
41,40,10,3609,-10,60,70,10,1,10,10,1,-10,60
41,41,11,4647,0,20,20,0,1,-20,20,,,40
41,42,12,3332,70,80,10,70,1,-30,30,0.714285714,70,40
41,43,13,3056,-20,40,60,20,1,0,0,-0.5,-10,60
41,44,14,3636,0,60,60,0,1,20,20,,,40
41,45,15,3179,10,80,70,10,1,10,10,0,10,60
41,46,16,2823,-20,0,20,20,1,-20,20,-0.5,-10,40
41,47,17,3419,-50,20,70,50,1,10,10,-0.2,-50,60
41,48,18,3401,20,100,80,20,1,20,20,-2,10,60
41,49,19,3195,10,40,30,10,1,-10,10,5,10,40
41,50,20,3221,-20,60,80,20,1,40,40,3,-10,40
41,51,21,3526,60,100,40,60,1,-20,20,0.666666667,50,60
41,52,22,3295,-40,40,80,40,1,20,20,0,-50,60
41,53,23,3101,20,40,20,20,1,-20,20,-1,10,40
41,54,24,3745,-60,20,80,60,1,20,20,0.333333333,-50,60
41,55,25,3227,20,20,0,20,1,-40,40,1,10,40
41,56,26,3669,0,60,60,0,1,0,0,,,60
41,57,27,3847,-20,0,20,20,1,-20,20,-1.5,-10,40
41,58,28,4783,30,80,50,30,1,10,10,,30,40
41,59,29,3412,0,80,80,0,1,20,20,,,60
42,0,0,4410,-50,0,50,50,1,10,10,0.4,-50,40
42,1,1,2922,-60,20,80,60,1,20,20,1,-50,60
42,2,2,3197,10,40,30,10,1,-10,10,0,10,40
42,3,3,2828,80,100,20,80,1,-40,40,0.375,70,60
42,4,4,2999,50,80,30,50,1,-10,10,0.4,50,40
42,5,5,2683,-30,20,50,30,1,10,10,0,-30,40
42,6,6,2719,30,80,50,30,1,-10,10,1,30,60
42,7,7,3391,-40,40,80,40,1,20,20,0.75,-50,60
42,8,8,3455,10,60,50,10,1,10,10,0,10,40
42,9,9,2798,10,60,50,10,1,-10,10,1,10,60
42,10,10,2995,20,80,60,20,1,0,0,-2,10,60
42,11,11,2581,30,80,50,30,1,10,10,-0.666666667,30,40
42,12,12,2810,-10,20,30,10,1,-10,10,0,-10,40
42,13,13,2896,20,40,20,20,1,-40,40,-0.5,10,60
42,14,14,3480,10,40,30,10,1,-10,10,0,10,40
42,15,15,2721,90,100,10,90,1,-50,50,0.444444444,70,60
42,16,16,3008,-30,0,30,30,1,-10,10,0.333333333,-30,40
42,17,17,3286,10,60,50,10,1,-10,10,0,10,60
42,18,18,2602,-30,20,50,30,1,-10,10,0,-30,60
42,19,19,3248,40,60,20,40,1,-20,20,0.75,50,40
42,20,20,3977,-30,20,50,30,1,10,10,1.333333333,-30,40
42,21,21,2714,-10,40,50,10,1,-10,10,0,-10,60
42,22,22,3042,30,80,50,30,1,-10,10,0,30,60
42,23,23,2971,30,40,10,30,1,-30,30,1.333333333,30,40
42,24,24,3038,-30,20,50,30,1,-10,10,0.666666667,-30,60
42,25,25,2729,30,80,50,30,1,10,10,-1.333333333,30,40
42,26,26,2890,30,60,30,30,1,-30,30,-0.333333333,30,60
42,27,27,4714,-10,0,10,10,1,-30,30,-1,-10,40
42,28,28,3884,40,60,20,40,1,-20,20,,50,40
42,29,29,3232,80,100,20,80,1,-40,40,,70,60
42,30,0,6137,50,70,20,50,0,-40,40,0.6,50,60
42,31,1,2798,10,60,50,10,0,10,10,0,10,40
42,32,2,3370,-30,20,50,30,0,10,10,0.666666667,-30,40
42,33,3,2675,30,80,50,30,0,-10,10,-0.666666667,30,60
42,34,4,2906,20,50,30,20,0,-30,30,3.5,10,60
42,35,5,3338,10,40,30,10,0,-10,10,2,10,40
42,36,6,3180,0,50,50,0,0,10,10,,,40
42,37,7,2980,-40,60,100,40,0,40,40,2.25,-50,60
42,38,8,2732,20,30,10,20,0,-30,30,3,10,40
42,39,9,2772,30,40,10,30,0,-50,50,2,30,60
42,40,10,2810,-50,20,70,50,0,30,30,0.4,-50,40
42,41,11,3795,10,80,70,10,0,10,10,-4,10,60
42,42,12,2917,10,40,30,10,0,-30,30,0,10,60
42,43,13,2654,-10,40,50,10,0,10,10,-2,-10,40
42,44,14,3800,30,60,30,30,0,-30,30,0.666666667,30,60
42,45,15,3588,-40,30,70,40,0,30,30,0.75,-50,40
42,46,16,3414,0,50,50,0,0,-10,10,,,60
42,47,17,2745,20,60,40,20,0,0,0,2,10,40
42,48,18,2678,20,70,50,20,0,-10,10,1.5,10,60
42,49,19,2961,-30,50,80,30,0,40,40,1.666666667,-30,40
42,50,20,2831,-30,50,80,30,0,20,20,1,-30,60
42,51,21,2712,30,80,50,30,0,-10,10,-0.333333333,30,60
42,52,22,3402,0,30,30,0,0,-10,10,,,40
42,53,23,2672,-30,20,50,30,0,10,10,0.666666667,-30,40
42,54,24,2879,20,60,40,20,0,-20,20,0.5,10,60
42,55,25,2765,20,50,30,20,0,-10,10,0,10,40
42,56,26,2716,10,40,30,10,0,-10,10,3,10,40
42,57,27,2655,20,70,50,20,0,-10,10,0,10,60
42,58,28,2742,-10,40,50,10,0,-10,10,,-10,60
42,59,29,3525,0,60,60,0,0,20,20,,,40
43,0,0,4744,0,50,50,0,0,-10,10,,,60
43,1,1,4482,-30,30,60,30,0,20,20,0.333333333,-30,40
43,2,2,4530,-10,40,50,10,0,10,10,4,-10,40
43,3,3,4495,-50,40,90,50,0,30,30,0.8,-50,60
43,4,4,4251,10,60,50,10,0,-10,10,0,10,60
43,5,5,4330,10,20,10,10,0,-30,30,2,10,40
43,6,6,5945,30,60,30,30,0,-10,10,0.333333333,30,40
43,7,7,5016,30,80,50,30,0,-10,10,0.666666667,30,60
43,8,8,5399,10,50,40,10,0,0,0,1,10,40
43,9,9,4494,0,70,70,0,0,10,10,,,60
43,10,10,4617,-10,40,50,10,0,10,10,2,-10,40
43,11,11,6045,-10,50,60,10,0,0,0,1,-10,60
43,12,12,4385,10,60,50,10,0,-10,10,1,10,60
43,13,13,4998,30,60,30,30,0,-10,10,0,30,40
43,14,14,5364,-20,40,60,20,0,0,0,0.5,-10,60
43,15,15,5289,20,50,30,20,0,-10,10,0.5,10,40
43,16,16,4433,20,70,50,20,0,-10,10,0.5,10,60
43,17,17,5660,-20,20,40,20,0,0,0,0,-10,40
43,18,18,4466,20,80,60,20,0,0,0,1.5,10,60
43,19,19,4583,-10,30,40,10,0,0,0,3,-10,40
43,20,20,4834,-30,60,90,30,0,30,30,1.333333333,-30,60
43,21,21,5472,-10,40,50,10,0,-10,10,-3,-10,60
43,22,22,5202,10,20,10,10,0,-30,30,4,10,40
43,23,23,5041,10,60,50,10,0,10,10,-2,10,40
43,24,24,3722,-10,70,80,10,0,20,20,2,-10,60
43,25,25,4796,0,30,30,0,0,-10,10,,,40
43,26,26,4198,0,40,40,0,0,0,0,,,40
43,27,27,4278,-10,50,60,10,0,0,0,-1,-10,60
43,28,28,4567,10,80,70,10,0,10,10,,10,60
43,29,29,4697,20,50,30,20,0,-10,10,,10,40
43,30,0,3826,60,80,20,60,1,-20,20,0.166666667,50,40
43,31,1,3277,50,80,30,50,1,-30,30,-0.4,50,60
43,32,2,6484,-30,0,30,30,1,-10,10,0.666666667,-30,40
43,33,3,2625,50,60,10,50,1,-50,50,0,50,60
43,34,4,3186,50,60,10,50,1,-30,30,-0.2,50,40
43,35,5,3608,40,40,0,40,1,-40,40,0.5,50,40
43,36,6,3432,90,100,10,90,1,-50,50,0.777777778,70,60
43,37,7,2993,-60,20,80,60,1,20,20,0,-50,60
43,38,8,3929,0,20,20,0,1,-20,20,,,40
43,39,9,7219,-40,40,80,40,1,20,20,0.75,-50,60
43,40,10,3105,10,60,50,10,1,-10,10,1,10,60
43,41,11,2663,70,80,10,70,1,-30,30,0.571428571,70,40
43,42,12,2872,-50,0,50,50,1,10,10,0,-50,40
43,43,13,2880,40,100,60,40,1,0,0,0.5,50,60
43,44,14,3090,10,60,50,10,1,10,10,-3,10,40
43,45,15,3208,0,80,80,0,1,20,20,,,60
43,46,16,2738,20,40,20,20,1,-20,20,,10,40
43,47,17,3555,-50,20,70,50,1,10,10,0.2,-50,60
43,48,18,6074,-20,40,60,20,1,0,0,0,-10,60
43,49,19,5607,,20,,,1,,,,,40
43,50,20,3873,70,80,10,70,1,-30,30,0.714285714,70,40
43,51,21,4899,20,80,60,20,1,0,0,0.5,10,60
43,52,22,6280,-50,20,70,50,1,10,10,1.2,-50,60
43,53,23,3786,0,60,60,0,1,20,20,,,40
43,54,24,3465,50,60,10,50,1,-50,50,1,50,60
43,55,25,2968,0,20,20,0,1,-20,20,,,40
43,56,26,3566,40,100,60,40,1,0,0,-1.25,50,60
43,57,27,3618,-10,40,50,10,1,10,10,4,-10,40
43,58,28,3216,-10,0,10,10,1,-30,30,,-10,40
43,59,29,3385,30,40,10,30,1,-50,50,,30,60
44,0,0,4438,-30,40,70,30,1,30,30,0.333333333,-30,40
44,1,1,3107,-30,40,70,30,1,10,10,0,-30,60
44,2,2,3528,-40,20,60,40,1,20,20,0.75,-50,40
44,3,3,3862,-10,60,70,10,1,10,10,3,-10,60
44,4,4,3449,50,80,30,50,1,-10,10,0.6,50,40
44,5,5,3859,0,60,60,0,1,20,20,,,40
44,6,6,4109,60,100,40,60,1,-20,20,0.5,50,60
44,7,7,4608,10,80,70,10,1,10,10,1,10,60
44,8,8,3396,-60,0,60,60,1,20,20,0.5,-50,40
44,9,9,3319,-60,20,80,60,1,20,20,0.166666667,-50,60
44,10,10,3034,-30,40,70,30,1,10,10,1,-30,60
44,11,11,3043,-30,0,30,30,1,-10,10,-1.333333333,-30,40
44,12,12,3412,-10,60,70,10,1,30,30,0,-10,40
44,13,13,3343,20,60,40,20,1,-20,20,0.5,10,60
44,14,14,2888,-50,20,70,50,1,30,30,0,-50,40
44,15,15,3511,30,80,50,30,1,-10,10,0.666666667,30,60
44,16,16,2925,-30,40,70,30,1,30,30,0.333333333,-30,40
44,17,17,3274,-50,20,70,50,1,10,10,0.6,-50,60
44,18,18,2980,60,100,40,60,1,-20,20,0.333333333,50,60
44,19,19,3163,20,80,60,20,1,20,20,0.5,10,40
44,20,20,2875,-30,40,70,30,1,30,30,1,-30,40
44,21,21,3120,0,60,60,0,1,0,0,,,60
44,22,22,2921,50,100,50,50,1,-10,10,0.2,50,60
44,23,23,3828,40,80,40,40,1,0,0,0.25,50,40
44,24,24,3198,-40,20,60,40,1,0,0,0,-50,60
44,25,25,3084,-30,20,50,30,1,10,10,0.666666667,-30,40
44,26,26,3012,-20,40,60,20,1,0,0,0,-10,60
44,27,27,3160,-30,0,30,30,1,-10,10,-0.333333333,-30,40
44,28,28,3360,20,60,40,20,1,0,0,,10,40
44,29,29,4195,20,80,60,20,1,0,0,,10,60
44,30,0,3337,-10,60,70,10,0,10,10,-2,-10,60
44,31,1,3991,0,50,50,0,0,10,10,,,40
44,32,2,3133,-20,30,50,20,0,10,10,0.5,-10,40
44,33,3,3494,-50,40,90,50,0,30,30,0.4,-50,60
44,34,4,2892,0,70,70,0,0,10,10,,,60
44,35,5,3147,20,60,40,20,0,0,0,2,10,40
44,36,6,4063,-60,20,80,60,0,40,40,0.333333333,-50,40
44,37,7,3755,0,50,50,0,0,-10,10,,,60
44,38,8,3031,-20,40,60,20,0,20,20,1,-10,40
44,39,9,2762,10,80,70,10,0,10,10,-1,10,60
44,40,10,3120,-20,20,40,20,0,0,0,0.5,-10,40
44,41,11,3737,-10,50,60,10,0,0,0,-1,-10,60
44,42,12,2902,-30,40,70,30,0,10,10,1,-30,60
44,43,13,2736,10,40,30,10,0,-10,10,1,10,40
44,44,14,2764,30,70,40,30,0,-20,20,1.333333333,30,60
44,45,15,2950,20,60,40,20,0,0,0,0.5,10,40
44,46,16,2700,-20,60,80,20,0,20,20,0.5,-10,60
44,47,17,2970,-20,30,50,20,0,10,10,0,-10,40
44,48,18,3379,10,80,70,10,0,10,10,1,10,60
44,49,19,2797,0,50,50,0,0,10,10,,,40
44,50,20,3147,-10,70,80,10,0,20,20,2,-10,60
44,51,21,2819,-20,40,60,20,0,0,0,-0.5,-10,60
44,52,22,2956,0,40,40,0,0,0,0,,,40
44,53,23,2823,-30,20,50,30,0,10,10,0.666666667,-30,40
44,54,24,2756,-20,50,70,20,0,10,10,0.5,-10,60
44,55,25,2952,0,30,30,0,0,-10,10,,,40
44,56,26,3247,20,60,40,20,0,0,0,0,10,40
44,57,27,2800,20,80,60,20,0,0,0,0.5,10,60
44,58,28,2812,-10,60,70,10,0,10,10,,-10,60
44,59,29,2887,10,50,40,10,0,0,0,,10,40
45,0,0,4627,10,60,50,10,1,10,10,0,10,40
45,1,1,4188,0,60,60,0,1,0,0,,,60
45,2,2,5072,-30,20,50,30,1,10,10,-1.333333333,-30,40
45,3,3,5298,-45,20,65,45,1,5,5,0.333333333,-50,60
45,4,4,4521,-90,0,90,90,1,50,50,0.777777778,-70,40
45,5,5,7009,20,40,20,20,1,-20,20,1.5,10,40
45,6,6,5266,50,100,50,50,1,-10,10,0.2,50,60
45,7,7,4762,20,80,60,20,1,0,0,-0.5,10,60
45,8,8,4550,30,80,50,30,1,10,10,0,30,40
45,9,9,4868,-10,40,50,10,1,-10,10,3,-10,60
45,10,10,4479,40,60,20,40,1,-40,40,1.25,50,60
45,11,11,4628,-10,40,50,10,1,10,10,-1,-10,40
45,12,12,4379,0,60,60,0,1,20,20,,,40
45,13,13,5080,10,80,70,10,1,10,10,-3,10,60
45,14,14,4252,30,80,50,30,1,10,10,0.333333333,30,40
45,15,15,4309,60,100,40,60,1,-20,20,0.666666667,50,60
45,16,16,4276,-40,20,60,40,1,20,20,-0.75,-50,40
45,17,17,4427,-60,20,80,60,1,20,20,0.333333333,-50,60
45,18,18,4360,-20,40,60,20,1,0,0,0,-10,60
45,19,19,4310,-90,0,90,90,1,50,50,0.333333333,-70,40
45,20,20,6420,20,80,60,20,1,20,20,-0.5,10,40
45,21,21,4593,40,100,60,40,1,0,0,,50,60
45,22,22,7010,,20,,,1,,,,,60
45,23,23,4479,-10,40,50,10,1,10,10,-3,-10,40
45,24,24,4431,-5,60,65,5,1,5,5,0,-10,60
45,25,25,4297,-80,0,80,80,1,40,40,0.5,-70,40
45,26,26,4877,-25,40,65,25,1,5,5,-0.2,-30,60
45,27,27,4475,-20,20,40,20,1,0,0,-0.5,-10,40
45,28,28,4349,10,60,50,10,1,10,10,,10,40
45,29,29,4352,10,80,70,10,1,10,10,,10,60
45,30,0,4955,30,80,50,30,0,-10,10,0.333333333,30,60
45,31,1,3813,-30,50,80,30,0,40,40,0.666666667,-30,40
45,32,2,4049,0,60,60,0,0,20,20,,,40
45,33,3,4457,10,70,60,10,0,0,0,-2,10,60
45,34,4,4868,20,60,40,20,0,-20,20,2,10,60
45,35,5,4785,-45,20,65,45,0,25,25,-0.111111111,-50,40
45,36,6,5447,-40,30,70,40,0,30,30,0.25,-50,40
45,37,7,4354,-40,40,80,40,0,20,20,0.75,-50,60
45,38,8,4262,-20,40,60,20,0,20,20,0.5,-10,40
45,39,9,4602,0,50,50,0,0,-10,10,,,60
45,40,10,4378,0,50,50,0,0,10,10,,,40
45,41,11,4324,-20,40,60,20,0,0,0,0,-10,60
45,42,12,4433,0,60,60,0,0,0,0,,,60
45,43,13,4486,-50,20,70,50,0,30,30,-0.2,-50,40
45,44,14,4402,-30,50,80,30,0,20,20,0.666666667,-30,60
45,45,15,4656,-50,30,80,50,0,40,40,0.6,-50,40
45,46,16,4446,20,80,60,20,0,0,0,0.5,10,60
45,47,17,4407,10,60,50,10,0,10,10,1,10,40
45,48,18,4949,0,70,70,0,0,10,10,,,60
45,49,19,4479,-20,40,60,20,0,20,20,-0.5,-10,40
45,50,20,4523,-20,50,70,20,0,10,10,0,-10,60
45,51,21,4794,-30,40,70,30,0,10,10,0,-30,60
45,52,22,4351,-20,50,70,20,0,30,30,1,-10,40
45,53,23,3970,-10,40,50,10,0,10,10,-2,-10,40
45,54,24,4470,-10,60,70,10,0,10,10,3,-10,60
45,55,25,4938,-50,20,70,50,0,30,30,0,-50,40
45,56,26,4347,-10,60,70,10,0,30,30,0,-10,40
45,57,27,4512,40,80,40,40,0,-20,20,0.25,50,60
45,58,28,4009,20,70,50,20,0,-10,10,,10,60
45,59,29,4727,-40,30,70,40,0,30,30,,-50,40
46,0,0,4792,-10,20,30,10,1,-10,10,0,-10,40
46,1,1,3507,-30,40,70,30,1,10,10,1,-30,60
46,2,2,4369,30,60,30,30,1,-10,10,2,30,40
46,3,3,4478,-20,20,40,20,1,-20,20,1,-10,60
46,4,4,4459,-50,40,90,50,1,50,50,1,-50,40
46,5,5,4771,40,80,40,40,1,0,0,-0.25,50,40
46,6,6,4401,40,60,20,40,1,-40,40,1,50,60
46,7,7,3910,40,100,60,40,1,0,0,0.25,50,60
46,8,8,4300,-30,0,30,30,1,-10,10,0,-30,40
46,9,9,5440,10,80,70,10,1,10,10,-4,10,60
46,10,10,4517,50,80,30,50,1,-30,30,0.8,50,60
46,11,11,4858,-10,20,30,10,1,-10,10,1,-10,40
46,12,12,4674,40,60,20,40,1,-20,20,0.75,50,40
46,13,13,5443,-50,20,70,50,1,10,10,0.2,-50,60
46,14,14,4989,30,80,50,30,1,10,10,,30,40
46,15,15,3982,40,100,60,40,1,0,0,-0.5,50,60
46,16,16,5670,,0,,,1,,,,,40
46,17,17,4994,20,60,40,20,1,-20,20,-1,10,60
46,18,18,4842,20,40,20,20,1,-40,40,1.5,10,60
46,19,19,4166,0,40,40,0,1,0,0,,,40
46,20,20,3759,40,80,40,40,1,0,0,1.5,50,40
46,21,21,4854,-10,40,50,10,1,-10,10,-1,-10,60
46,22,22,4102,40,100,60,40,1,0,0,-0.75,50,60
46,23,23,5320,-40,60,100,40,1,60,60,1.25,-50,40
46,24,24,5138,30,60,30,30,1,-30,30,0.666666667,30,60
46,25,25,4373,-10,40,50,10,1,10,10,-1,-10,40
46,26,26,4099,-30,20,50,30,1,-10,10,0,-30,60
46,27,27,4041,-60,0,60,60,1,20,20,0.5,-50,40
46,28,28,4025,-10,20,30,10,1,-10,10,,-10,40
46,29,29,5401,30,80,50,30,1,-10,10,,30,60
46,30,0,3692,10,70,60,10,0,0,0,-2,10,60
46,31,1,3929,-10,60,70,10,0,30,30,2,-10,40
46,32,2,4784,-10,40,50,10,0,10,10,2,-10,40
46,33,3,4111,10,50,40,10,0,-20,20,-1,10,60
46,34,4,5334,10,40,30,10,0,-30,30,3,10,60
46,35,5,4384,-10,20,30,10,0,-10,10,1,-10,40
46,36,6,4960,30,50,20,30,0,-20,20,0,30,40
46,37,7,4661,20,80,60,20,0,0,0,0,10,60
46,38,8,4573,10,30,20,10,0,-20,20,2,10,40
46,39,9,4172,0,60,60,0,0,0,0,,,60
46,40,10,4260,20,60,40,20,0,0,0,0.5,10,40
46,41,11,5023,10,80,70,10,0,10,10,-4,10,60
46,42,12,4450,20,50,30,20,0,-30,30,2,10,60
46,43,13,4360,0,50,50,0,0,10,10,,,40
46,44,14,6897,0,70,70,0,0,10,10,,,60
46,45,15,7004,,20,,,0,,,,,40
46,46,16,4083,20,60,40,20,0,-20,20,0,10,60
46,47,17,4438,-10,30,40,10,0,0,0,1,-10,40
46,48,18,4229,0,40,40,0,0,-20,20,,,60
46,49,19,4528,10,40,30,10,0,-10,10,1,10,40
46,50,20,7001,,70,,,0,,,,,60
46,51,21,3834,50,80,30,50,0,-30,30,0.8,50,60
46,52,22,4070,10,50,40,10,0,0,0,-2,10,40
46,53,23,4561,10,30,20,10,0,-20,20,1,10,40
46,54,24,3405,-30,40,70,30,0,10,10,0.333333333,-30,60
46,55,25,4216,30,60,30,30,0,-10,10,0.333333333,30,40
46,56,26,5252,0,40,40,0,0,0,0,,,40
46,57,27,5513,-10,50,60,10,0,0,0,3,-10,60
46,58,28,5601,30,60,30,30,0,-30,30,,30,60
46,59,29,4671,-10,20,30,10,0,-10,10,,-10,40
47,0,0,4690,-60,0,60,60,1,20,20,0.666666667,-50,40
47,1,1,3035,60,100,40,60,1,-20,20,1,50,60
47,2,2,3049,0,20,20,0,1,-20,20,,,40
47,3,3,4531,-60,40,100,60,1,40,40,0.833333333,-50,60
47,4,4,2825,20,60,40,20,1,0,0,0.5,10,40
47,5,5,2889,30,80,50,30,1,10,10,-0.166666667,30,40
47,6,6,4173,10,60,50,10,1,-10,10,-3,10,60
47,7,7,2848,60,80,20,60,1,-40,40,0.166666667,50,60
47,8,8,3754,-5,40,45,5,1,5,5,-3,-10,40
47,9,9,3796,-10,20,30,10,1,-30,30,-1,-10,60
47,10,10,3134,20,60,40,20,1,-20,20,-1,10,60
47,11,11,3205,20,80,60,20,1,20,20,-0.5,10,40
47,12,12,2955,-30,20,50,30,1,10,10,0,-30,40
47,13,13,3348,60,80,20,60,1,-40,40,0.333333333,50,60
47,14,14,4369,10,60,50,10,1,10,10,1,10,40
47,15,15,3483,0,40,40,0,1,-20,20,,,60
47,16,16,3295,-60,0,60,60,1,20,20,0.333333333,-50,40
47,17,17,2877,50,100,50,50,1,-10,10,0.2,50,60
47,18,18,4457,-40,20,60,40,1,0,0,0,-50,60
47,19,19,4054,0,40,40,0,1,0,0,,,40
47,20,20,3993,20,60,40,20,1,0,0,-0.5,10,40
47,21,21,2895,0,60,60,0,1,0,0,,,60
47,22,22,3103,-30,20,50,30,1,-10,10,0,-30,60
47,23,23,2956,50,80,30,50,1,-10,10,0.6,50,40
47,24,24,3205,50,100,50,50,1,-10,10,0,50,60
47,25,25,4160,-60,0,60,60,1,20,20,0.333333333,-50,40
47,26,26,2787,30,80,50,30,1,-10,10,0,30,60
47,27,27,3465,0,40,40,0,1,0,0,,,40
47,28,28,3821,-10,20,30,10,1,-10,10,,-10,40
47,29,29,2931,-10,40,50,10,1,-10,10,,-10,60
47,30,0,3222,0,40,40,0,0,-20,20,,,60
47,31,1,2889,-40,20,60,40,0,20,20,0.75,-50,40
47,32,2,3124,0,30,30,0,0,-10,10,,,40
47,33,3,3319,0,50,50,0,0,-10,10,,,60
47,34,4,3192,40,80,40,40,0,-20,20,0.25,50,60
47,35,5,3384,10,40,30,10,0,-10,10,0,10,40
47,36,6,3329,20,50,30,20,0,-10,10,0.5,10,40
47,37,7,4168,10,60,50,10,0,-10,10,1,10,60
47,38,8,3102,20,60,40,20,0,0,0,-0.5,10,40
47,39,9,4024,10,70,60,10,0,0,0,-1,10,60
47,40,10,3650,10,40,30,10,0,-10,10,-1,10,40
47,41,11,3987,10,60,50,10,0,-10,10,-2,10,60
47,42,12,4498,40,70,30,40,0,-30,30,1,50,60
47,43,13,2822,30,50,20,30,0,-20,20,0.333333333,30,40
47,44,14,2889,-30,40,70,30,0,10,10,0.333333333,-30,60
47,45,15,3258,30,60,30,30,0,-10,10,0,30,40
47,46,16,3978,20,80,60,20,0,0,0,-0.5,10,60
47,47,17,2930,-10,20,30,10,0,-10,10,0,-10,40
47,48,18,3913,0,50,50,0,0,-10,10,,,60
47,49,19,2712,0,30,30,0,0,-10,10,,,40
47,50,20,3179,-10,70,80,10,0,20,20,4,-10,60
47,51,21,3035,40,80,40,40,0,-20,20,0.15,50,60
47,52,22,2937,0,30,30,0,0,-10,10,,,40
47,53,23,3223,10,60,50,10,0,10,10,1,10,40
47,54,24,5161,4,50,46,4,0,-14,14,6,10,60
47,55,25,4201,-40,20,60,40,0,20,20,0.5,-50,40
47,56,26,3281,10,50,40,10,0,0,0,1,10,40
47,57,27,3805,-30,40,70,30,0,10,10,0.333333333,-30,60
47,58,28,3624,0,60,60,0,0,0,0,,,60
47,59,29,4009,-10,40,50,10,0,10,10,,-10,40
48,0,0,2886,-40,0,40,40,1,0,0,1,-50,40
48,1,1,3059,40,80,40,40,1,-20,20,0.5,50,60
48,2,2,2669,60,60,0,60,1,-40,40,0.333333333,50,40
48,3,3,2866,0,60,60,0,1,0,0,,,60
48,4,4,2784,20,40,20,20,1,-20,20,1.5,10,40
48,5,5,2652,-30,20,50,30,1,10,10,-1.666666667,-30,40
48,6,6,2835,-20,20,40,20,1,-20,20,1,-10,60
48,7,7,2823,80,100,20,80,1,-40,40,0.375,70,60
48,8,8,3110,-20,80,100,20,1,60,60,4,-10,40
48,9,9,2650,-10,40,50,10,1,-10,10,1,-10,60
48,10,10,2718,0,40,40,0,1,-20,20,,,60
48,11,11,2567,40,60,20,40,1,-20,20,0.5,50,40
48,12,12,2795,-20,20,40,20,1,0,0,0,-10,40
48,13,13,2701,0,20,20,0,1,-40,40,,,60
48,14,14,2689,0,40,40,0,1,0,0,,,40
48,15,15,2907,60,60,0,60,1,-60,60,0.333333333,50,60
48,16,16,2910,-40,0,40,40,1,0,0,0,-50,40
48,17,17,2810,60,80,20,60,1,-40,40,0.666666667,50,60
48,18,18,2650,40,100,60,40,1,0,0,-1,50,60
48,19,19,2762,40,80,40,40,1,0,0,0,50,40
48,20,20,2865,-20,20,40,20,1,0,0,0,-10,40
48,21,21,3047,0,20,20,0,1,-40,40,,,60
48,22,22,2736,60,100,40,60,1,-20,20,-0.333333333,50,60
48,23,23,3121,0,40,40,0,1,0,0,,,40
48,24,24,2932,40,60,20,40,1,-40,40,0.5,50,60
48,25,25,3463,60,80,20,60,1,-20,20,0,50,40
48,26,26,2989,0,40,40,0,1,-20,20,,,60
48,27,27,2925,40,60,20,40,1,-20,20,0,50,40
48,28,28,3323,-20,0,20,20,1,-20,20,,-10,40
48,29,29,2903,40,80,40,40,1,-20,20,,50,60
48,30,0,3160,20,60,40,20,0,-20,20,0.5,10,60
48,31,1,3782,20,40,20,20,0,-20,20,1,10,40
48,32,2,2882,20,60,40,20,0,0,0,0.5,10,40
48,33,3,3647,30,80,50,30,0,-10,10,-0.333333333,30,60
48,34,4,3028,30,70,40,30,0,-20,20,0.333333333,30,60
48,35,5,3672,-20,30,50,20,0,10,10,0.5,-10,40
48,36,6,3230,-20,20,40,20,0,0,0,-1,-10,40
48,37,7,2731,0,50,50,0,0,-10,10,,,60
48,38,8,2679,-10,50,60,10,0,20,20,0,-10,40
48,39,9,3395,0,40,40,0,0,-20,20,,,60
48,40,10,2733,-20,40,60,20,0,20,20,-1,-10,40
48,41,11,2842,10,50,40,10,0,-20,20,1,10,60
48,42,12,2892,20,70,50,20,0,-10,10,1,10,60
48,43,13,3075,-20,60,80,20,0,40,40,1.5,-10,40
48,44,14,2842,-10,60,70,10,0,10,10,5,-10,60
48,45,15,3307,-30,20,50,30,0,10,10,0.333333333,-30,40
48,46,16,3069,20,40,20,20,0,-40,40,1.5,10,60
48,47,17,2943,-10,30,40,10,0,0,0,-2,-10,40
48,48,18,3076,30,80,50,30,0,-10,10,0.333333333,30,60
48,49,19,3101,-10,50,60,10,0,20,20,2,-10,40
48,50,20,2926,-10,50,60,10,0,0,0,1,-10,60
48,51,21,5043,20,70,50,20,0,-10,10,0,10,60
48,52,22,3069,-10,30,40,10,0,0,0,1,-10,40
48,53,23,3557,30,60,30,30,0,-10,10,0.333333333,30,40
48,54,24,2744,-10,40,50,10,0,-10,10,0,-10,60
48,55,25,2744,0,40,40,0,0,0,0,,,40
48,56,26,3005,-10,50,60,10,0,20,20,0,-10,40
48,57,27,3040,30,80,50,30,0,-10,10,-0.333333333,30,60
48,58,28,3059,20,60,40,20,0,-20,20,,10,60
48,59,29,2993,-40,20,60,40,0,20,20,,-50,40
49,0,0,5142,30,80,50,30,0,-10,10,0.833333333,30,60
49,1,1,2785,0,50,50,0,0,10,10,,,40
49,2,2,2705,20,60,40,20,0,0,0,0.5,10,40
49,3,3,3023,-25,50,75,25,0,15,15,0.6,-30,60
49,4,4,3138,-20,40,60,20,0,0,0,-0.25,-10,60
49,5,5,2618,-30,20,50,30,0,10,10,0.533333333,-30,40
49,6,6,2833,6,40,34,6,0,-6,6,0.166666667,10,40
49,7,7,3131,5,70,65,5,0,5,5,-1,10,60
49,8,8,3569,-5,30,35,5,0,-5,5,-1,-10,40
49,9,9,3752,0,60,60,0,0,0,0,,,60
49,10,10,3296,0,40,40,0,0,0,0,,,40
49,11,11,2950,-5,60,65,5,0,5,5,-2,-10,60
49,12,12,3699,-25,50,75,25,0,15,15,0.2,-30,60
49,13,13,3520,25,60,35,25,0,-5,5,-0.6,30,40
49,14,14,3633,10,80,70,10,0,10,10,0,10,60
49,15,15,3658,0,20,20,0,0,-20,20,,,40
49,16,16,3050,0,70,70,0,0,10,10,,,60
49,17,17,2537,0,30,30,0,0,-10,10,,,40
49,18,18,3538,-25,40,65,25,0,5,5,0.2,-30,60
49,19,19,2587,20,50,30,20,0,-10,10,0.5,10,40
49,20,20,3383,-10,50,60,10,0,0,0,-1,-10,60
49,21,21,3304,-30,40,70,30,0,10,10,1,-30,60
49,22,22,3766,20,60,40,20,0,0,0,0,10,40
49,23,23,4001,-20,20,40,20,0,0,0,0.5,-10,40
49,24,24,2707,40,80,40,40,0,-20,20,0.5,50,60
49,25,25,2582,10,40,30,10,0,-10,10,-1,10,40
49,26,26,2842,10,30,20,10,0,-20,20,2,10,40
49,27,27,3402,0,60,60,0,0,0,0,,,60
49,28,28,2699,0,70,70,0,0,10,10,,,60
49,29,29,2664,10,50,40,10,0,0,0,,10,40
49,30,0,2623,-50,0,50,50,1,10,10,0.4,-50,40
49,31,1,3503,-20,40,60,20,1,0,0,1,-10,60
49,32,2,2696,50,80,30,50,1,-10,10,1,50,40
49,33,3,2563,-20,20,40,20,1,-20,20,0,-10,60
49,34,4,2913,-20,60,80,20,1,40,40,0.5,-10,40
49,35,5,2593,-30,40,70,30,1,30,30,0.166666667,-30,40
49,36,6,2944,20,60,40,20,1,-20,20,-0.5,10,60
49,37,7,2643,50,80,30,50,1,-30,30,0.4,50,60
49,38,8,3682,-45,20,65,45,1,25,25,0,-50,40
49,39,9,2561,50,100,50,50,1,-10,10,0.4,50,60
49,40,10,3848,10,80,70,10,1,10,10,-2,10,60
49,41,11,3544,-45,20,65,45,1,25,25,0.555555556,-50,40
49,42,12,3354,40,80,40,40,1,0,0,0.75,50,40
49,43,13,2986,-30,20,50,30,1,-10,10,-1.333333333,-30,60
49,44,14,4163,-70,0,70,70,1,30,30,0.428571429,-70,40
49,45,15,2816,-50,40,90,50,1,30,30,0.6,-50,60
49,46,16,3223,0,40,40,0,1,0,0,,,40
49,47,17,2816,0,60,60,0,1,0,0,,,60
49,48,18,2874,20,100,80,20,1,20,20,0,10,60
49,49,19,2950,-10,60,70,10,1,30,30,5,-10,40
49,50,20,3755,0,20,20,0,1,-20,20,,,40
49,51,21,2746,-40,40,80,40,1,20,20,0.5,-50,60
49,52,22,4033,0,60,60,0,1,0,0,,,60
49,53,23,4297,40,80,40,40,1,0,0,0.25,50,40
49,54,24,4499,20,80,60,20,1,0,0,0,10,60
49,55,25,5385,-50,0,50,50,1,10,10,-0.2,-50,40
49,56,26,4393,40,100,60,40,1,0,0,0.5,50,60
49,57,27,2691,0,60,60,0,1,20,20,,,40
49,58,28,2539,-30,40,70,30,1,30,30,,-30,40
49,59,29,2698,-60,20,80,60,1,20,20,,-50,60
50,0,0,3491,20,40,20,20,1,-20,20,2,10,40
50,1,1,3468,40,60,20,40,1,-40,40,1,50,60
50,2,2,2956,20,80,60,20,1,20,20,1,10,40
50,3,3,3240,40,100,60,40,1,0,0,0.5,50,60
50,4,4,3067,-80,0,80,80,1,40,40,0.375,-70,40
50,5,5,3614,-30,20,50,30,1,10,10,-0.333333333,-30,40
50,6,6,2928,0,80,80,0,1,20,20,,,60
50,7,7,2794,20,40,20,20,1,-40,40,0,10,60
50,8,8,3260,0,60,60,0,1,20,20,,,40
50,9,9,2789,0,20,20,0,1,-40,40,,,60
50,10,10,2923,20,60,40,20,1,-20,20,0,10,60
50,11,11,3525,20,80,60,20,1,20,20,2,10,40
50,12,12,2967,-60,40,100,60,1,60,60,0.333333333,-50,40
50,13,13,6217,-20,20,40,20,1,-20,20,-2.5,-10,60
50,14,14,3290,-20,60,80,20,1,40,40,0.5,-10,40
50,15,15,4279,-10,80,90,10,1,30,30,7,-10,60
50,16,16,3482,-70,0,70,70,1,30,30,1,-70,40
50,17,17,2862,20,40,20,20,1,-40,40,0,10,60
50,18,18,3310,80,100,20,80,1,-40,40,0.375,70,60
50,19,19,2722,20,20,0,20,1,-40,40,1,10,40
50,20,20,3202,0,20,20,0,1,-20,20,,,40
50,21,21,3576,-30,20,50,30,1,-10,10,-1.666666667,-30,60
50,22,22,3694,-60,40,100,60,1,40,40,,-50,60
50,23,23,7006,,0,,,1,,,,,40
50,24,24,7003,,100,,,1,,,,,60
50,25,25,7003,,80,,,1,,,,,40
50,26,26,3682,-40,60,100,40,1,40,40,2,-50,60
50,27,27,5897,40,60,20,40,1,-20,20,1,50,40
50,28,28,3392,-20,40,60,20,1,20,20,,-10,40
50,29,29,3112,60,80,20,60,1,-40,40,,50,60
50,30,0,4404,60,80,20,60,0,-40,40,0,50,60
50,31,1,3080,40,60,20,40,0,-20,20,0.5,50,40
50,32,2,3256,-20,20,40,20,0,0,0,-0.5,-10,40
50,33,3,3256,50,70,20,50,0,-40,40,1.6,50,60
50,34,4,4018,-60,40,100,60,0,40,40,0.166666667,-50,60
50,35,5,3619,-10,40,50,10,0,10,10,0,-10,40
50,36,6,3239,-20,30,50,20,0,10,10,1.5,-10,40
50,37,7,3359,-30,60,90,30,0,30,30,1,-30,60
50,38,8,2944,30,50,20,30,0,-20,20,0.666666667,30,40
50,39,9,2998,-10,50,60,10,0,0,0,4,-10,60
50,40,10,3069,0,40,40,0,0,0,0,,,40
50,41,11,3517,30,50,20,30,0,-40,40,1,30,60
50,42,12,3440,-10,40,50,10,0,-10,10,-1,-10,60
50,43,13,3181,10,60,50,10,0,10,10,4,10,40
50,44,14,3036,10,70,60,10,0,0,0,2,10,60
50,45,15,4141,-70,20,90,70,0,50,50,0.428571429,-70,40
50,46,16,3507,0,80,80,0,0,20,20,,,60
50,47,17,3926,-30,30,60,30,0,20,20,0,-30,40
50,48,18,3242,-10,60,70,10,0,10,10,1,-10,60
50,49,19,3031,-10,50,60,10,0,20,20,1,-10,40
50,50,20,3248,-20,40,60,20,0,0,0,2.5,-10,60
50,51,21,3431,40,50,10,40,0,-50,50,1.25,50,60
50,52,22,3184,-30,20,50,30,0,10,10,0,-30,40
50,53,23,3217,10,60,50,10,0,10,10,-3,10,40
50,54,24,2979,10,70,60,10,0,0,0,0,10,60
50,55,25,3375,20,40,20,20,0,-20,20,0,10,40
50,56,26,2910,10,30,20,10,0,-20,20,1,10,40
50,57,27,2946,20,80,60,20,0,0,0,0,10,60
50,58,28,3207,0,60,60,0,0,0,0,,,60
50,59,29,3106,20,50,30,20,0,-10,10,,10,40
51,0,0,5737,-10,50,60,10,0,0,0,0,-10,60
51,1,1,5931,10,50,40,10,0,0,0,0,10,40
51,2,2,5098,-20,20,40,20,0,0,0,1,-10,40
51,3,3,4340,20,80,60,20,0,0,0,0.5,10,60
51,4,4,4286,0,70,70,0,0,10,10,,,60
51,5,5,4093,40,60,20,40,0,-20,20,1.25,50,40
51,6,6,3816,-40,30,70,40,0,30,30,0.5,-50,40
51,7,7,4099,0,40,40,0,0,-20,20,,,60
51,8,8,3988,-10,40,50,10,0,10,10,0,-10,40
51,9,9,3925,0,60,60,0,0,0,0,,,60
51,10,10,4422,-20,30,50,20,0,10,10,1.5,-10,40
51,11,11,3767,-10,50,60,10,0,0,0,-2,-10,60
51,12,12,3925,0,80,80,0,0,20,20,,,60
51,13,13,4059,40,60,20,40,0,-20,20,0.5,50,40
51,14,14,4355,30,70,40,30,0,-20,20,1.666666667,30,60
51,15,15,4084,-20,20,40,20,0,0,0,0,-10,40
51,16,16,3983,-50,40,90,50,0,30,30,0.2,-50,60
51,17,17,4534,0,40,40,0,0,0,0,,,40
51,18,18,3996,-20,60,80,20,0,20,20,2,-10,60
51,19,19,5984,30,50,20,30,0,-20,20,1.666666667,30,40
51,20,20,3877,20,60,40,20,0,-20,20,2,10,60
51,21,21,3790,0,80,80,0,0,20,20,,,60
51,22,22,3716,-40,30,70,40,0,30,30,0.75,-50,40
51,23,23,3962,-20,20,40,20,0,0,0,0,-10,40
51,24,24,3721,0,50,50,0,0,-10,10,,,60
51,25,25,3842,0,40,40,0,0,0,0,,,40
51,26,26,4241,40,60,20,40,0,-20,20,0,50,40
51,27,27,3717,0,70,70,0,0,10,10,,,60
51,28,28,6290,-20,40,60,20,0,0,0,,-10,60
51,29,29,4119,30,50,20,30,0,-20,20,,30,40
51,30,0,5427,-20,60,80,20,1,40,40,0,-10,40
51,31,1,3736,-20,20,40,20,1,-20,20,0.5,-10,60
51,32,2,3960,-40,40,80,40,1,40,40,0.25,-50,40
51,33,3,5756,70,100,30,70,1,-30,30,0.142857143,70,60
51,34,4,3851,-70,0,70,70,1,30,30,-0.142857143,-70,40
51,35,5,4252,-60,20,80,60,1,40,40,-0.166666667,-50,40
51,36,6,4365,20,60,40,20,1,-20,20,-1,10,60
51,37,7,4242,20,40,20,20,1,-40,40,0.5,10,60
51,38,8,3863,-10,80,90,10,1,50,50,3,-10,40
51,39,9,4049,50,80,30,50,1,-30,30,0.2,50,60
51,40,10,4542,60,100,40,60,1,-20,20,-0.166666667,50,60
51,41,11,3883,-40,20,60,40,1,20,20,-0.5,-50,40
51,42,12,4272,-40,40,80,40,1,40,40,1,-50,40
51,43,13,4235,-10,20,30,10,1,-30,30,-1,-10,60
51,44,14,3818,40,80,40,40,1,0,0,0,50,40
51,45,15,3817,0,40,40,0,1,-20,20,,,60
51,46,16,3829,-40,0,40,40,1,0,0,-0.75,-50,40
51,47,17,4204,20,60,40,20,1,-20,20,-0.5,10,60
51,48,18,3922,50,80,30,50,1,-30,30,1,50,60
51,49,19,4168,-10,60,70,10,1,30,30,0,-10,40
51,50,20,3611,-30,40,70,30,1,30,30,-0.333333333,-30,40
51,51,21,3909,0,80,80,0,1,20,20,,,60
51,52,22,4157,-10,60,70,10,1,10,10,5,-10,60
51,53,23,7002,0,80,80,0,1,40,40,,,40
51,54,24,3911,80,100,20,80,1,-40,40,0,70,60
51,55,25,3985,-40,0,40,40,1,0,0,0,-50,40
51,56,26,4150,20,40,20,20,1,-40,40,3,10,60
51,57,27,4965,-20,20,40,20,1,0,0,-1,-10,40
51,58,28,4373,0,60,60,0,1,20,20,,,40
51,59,29,5067,-60,20,80,60,1,20,20,,-50,60
52,0,0,5351,-50,20,70,50,1,30,30,0.8,-50,40
52,1,1,3504,30,80,50,30,1,-10,10,-1,30,60
52,2,2,3007,10,40,30,10,1,-10,10,1,10,40
52,3,3,3536,0,20,20,0,1,-40,40,,,60
52,4,4,5624,40,80,40,40,1,0,0,0.75,50,40
52,5,5,2954,-70,0,70,70,1,30,30,0.571428571,-70,40
52,6,6,3399,-20,40,60,20,1,0,0,0.5,-10,60
52,7,7,3342,50,100,50,50,1,-10,10,0.4,50,60
52,8,8,2990,30,60,30,30,1,-10,10,0,30,40
52,9,9,3074,-10,60,70,10,1,10,10,1,-10,60
52,10,10,3430,0,60,60,0,1,0,0,,,60
52,11,11,4219,-10,20,30,10,1,-10,10,-1,-10,40
52,12,12,4368,0,40,40,0,1,0,0,,,40
52,13,13,2988,-40,20,60,40,1,0,0,0,-50,60
52,14,14,5000,50,80,30,50,1,-10,10,0.2,50,40
52,15,15,3290,-20,40,60,20,1,0,0,0.5,-10,60
52,16,16,2970,20,60,40,20,1,0,0,0,10,40
52,17,17,3849,30,80,50,30,1,-10,10,0.333333333,30,60
52,18,18,2952,40,100,60,40,1,0,0,0,50,60
52,19,19,4951,-40,0,40,40,1,0,0,0.5,-50,40
52,20,20,4962,20,40,20,20,1,-20,20,0.5,10,40
52,21,21,3104,20,80,60,20,1,0,0,0.5,10,60
52,22,22,3738,-10,60,70,10,1,10,10,1,-10,60
52,23,23,3786,-10,20,30,10,1,-10,10,0,-10,40
52,24,24,5040,-40,20,60,40,1,0,0,-0.5,-50,60
52,25,25,2898,-30,0,30,30,1,-10,10,0,-30,40
52,26,26,3621,-40,40,80,40,1,20,20,0.5,-50,60
52,27,27,5594,50,80,30,50,1,-10,10,0.4,50,40
52,28,28,6594,10,60,50,10,1,10,10,,10,40
52,29,29,3245,40,100,60,40,1,0,0,,50,60
52,30,0,4321,20,50,30,20,0,-30,30,1.5,10,60
52,31,1,3437,-30,30,60,30,0,20,20,1.333333333,-30,40
52,32,2,3365,20,40,20,20,0,-20,20,1,10,40
52,33,3,2855,-20,40,60,20,0,0,0,0.5,-10,60
52,34,4,2956,30,80,50,30,0,-10,10,0.333333333,30,60
52,35,5,3943,10,50,40,10,0,0,0,-1,10,40
52,36,6,2845,-10,20,30,10,0,-10,10,0,-10,40
52,37,7,2900,0,60,60,0,0,0,0,,,60
52,38,8,3902,30,60,30,30,0,-10,10,0.333333333,30,40
52,39,9,3574,20,70,50,20,0,-10,10,1,10,60
52,40,10,4316,20,60,40,20,0,0,0,0,10,40
52,41,11,4171,0,70,70,0,0,10,10,,,60
52,42,12,3200,0,60,60,0,0,0,0,,,60
52,43,13,3734,10,50,40,10,0,0,0,-1,10,40
52,44,14,5089,-10,40,50,10,0,-10,10,-2,-10,60
52,45,15,3004,0,30,30,0,0,-10,10,,,40
52,46,16,2888,-20,50,70,20,0,10,10,-0.5,-10,60
52,47,17,3184,-20,20,40,20,0,0,0,0,-10,40
52,48,18,2982,0,80,80,0,0,20,20,,,60
52,49,19,2905,0,40,40,0,0,0,0,,,40
52,50,20,3253,20,80,60,20,0,0,0,0.5,10,60
52,51,21,2873,-30,40,70,30,0,10,10,0.333333333,-30,60
52,52,22,2881,20,60,40,20,0,0,0,0.5,10,40
52,53,23,3808,-10,40,50,10,0,10,10,1,-10,40
52,54,24,3312,10,70,60,10,0,0,0,0,10,60
52,55,25,4495,-20,20,40,20,0,0,0,0.5,-10,40
52,56,26,4269,20,50,30,20,0,-10,10,0.5,10,40
52,57,27,3766,-10,50,60,10,0,0,0,1,-10,60
52,58,28,3863,10,60,50,10,0,-10,10,,10,60
52,59,29,4184,-10,30,40,10,0,0,0,,-10,40
53,0,0,5272,-20,40,60,20,0,0,0,-1,-10,60
53,1,1,4852,10,60,50,10,0,10,10,-1,10,40
53,2,2,4976,10,50,40,10,0,0,0,1,10,40
53,3,3,4852,-30,50,80,30,0,20,20,1.333333333,-30,60
53,4,4,5184,30,70,40,30,0,-20,20,1,30,60
53,5,5,4669,-30,20,50,30,0,10,10,0,-30,40
53,6,6,5081,-10,40,50,10,0,10,10,2,-10,40
53,7,7,4850,10,80,70,10,0,10,10,0,10,60
53,8,8,5504,0,30,30,0,0,-10,10,,,40
53,9,9,4644,-10,60,70,10,0,10,10,1,-10,60
53,10,10,5951,20,50,30,20,0,-10,10,2,10,40
53,11,11,7160,10,70,60,10,0,0,0,-4,10,60
53,12,12,5806,20,40,20,20,0,-40,40,3.5,10,60
53,13,13,5078,-50,20,70,50,0,30,30,0.2,-50,40
53,14,14,4601,-10,80,90,10,0,30,30,0,-10,60
53,15,15,4617,0,60,60,0,0,20,20,,,40
53,16,16,4620,-30,60,90,30,0,30,30,1.666666667,-30,60
53,17,17,4579,-10,40,50,10,0,10,10,1,-10,40
53,18,18,4991,10,50,40,10,0,-20,20,3,10,60
53,19,19,4899,-10,30,40,10,0,0,0,0,-10,40
53,20,20,4762,-20,50,70,20,0,10,10,0.5,-10,60
53,21,21,4707,-20,40,60,20,0,0,0,-1,-10,60
53,22,22,4723,-10,30,40,10,0,0,0,0,-10,40
53,23,23,5887,10,50,40,10,0,0,0,1,10,40
53,24,24,4648,0,80,80,0,0,20,20,,,60
53,25,25,5890,10,60,50,10,0,10,10,-2,10,40
53,26,26,4478,-10,20,30,10,0,-10,10,0,-10,40
53,27,27,5058,-30,60,90,30,0,30,30,1,-30,60
53,28,28,5328,10,70,60,10,0,0,0,,10,60
53,29,29,4653,10,40,30,10,0,-10,10,,10,40
53,30,0,5289,-20,20,40,20,1,0,0,1,-10,40
53,31,1,4559,40,80,40,40,1,-20,20,-0.25,50,60
53,32,2,4943,20,40,20,20,1,-20,20,1,10,40
53,33,3,4976,-10,20,30,10,1,-30,30,-1,-10,60
53,34,4,4028,-40,0,40,40,1,0,0,0.25,-50,40
53,35,5,5966,50,80,30,50,1,-10,10,0.2,50,40
53,36,6,4646,60,100,40,60,1,-20,20,0.5,50,60
53,37,7,4976,-10,60,70,10,1,10,10,1,-10,60
53,38,8,4932,20,60,40,20,1,0,0,0,10,40
53,39,9,4647,-20,40,60,20,1,0,0,0.5,-10,60
53,40,10,5416,50,100,50,50,1,-10,10,0,50,60
53,41,11,6405,-40,0,40,40,1,0,0,0.25,-50,40
53,42,12,4563,10,40,30,10,1,-10,10,-1,10,40
53,43,13,4896,30,80,50,30,1,-10,10,0.666666667,30,60
53,44,14,5330,0,20,20,0,1,-20,20,,,40
53,45,15,4801,-50,20,70,50,1,10,10,0.4,-50,60
53,46,16,4599,10,60,50,10,1,10,10,-1,10,40
53,47,17,5557,-10,40,50,10,1,-10,10,2,-10,60
53,48,18,5219,30,60,30,30,1,-30,30,1.333333333,30,60
53,49,19,5032,40,80,40,40,1,0,0,1,50,40
53,50,20,6780,-20,60,80,20,1,40,40,2,-10,40
53,51,21,5995,-50,20,70,50,1,10,10,0.4,-50,60
53,52,22,6563,10,60,50,10,1,-10,10,2,10,60
53,53,23,4646,-40,0,40,40,1,0,0,-1,-50,40
53,54,24,4830,-30,40,70,30,1,10,10,0,-30,60
53,55,25,4902,0,80,80,0,1,40,40,,,40
53,56,26,4765,30,100,70,30,1,10,10,0,30,60
53,57,27,5140,-30,20,50,30,1,10,10,0.333333333,-30,40
53,58,28,5276,0,40,40,0,1,0,0,,,40
53,59,29,4537,10,80,70,10,1,10,10,,10,60
54,0,0,3959,-20,40,60,20,1,20,20,1,-10,40
54,1,1,3672,-10,60,70,10,1,10,10,2,-10,60
54,2,2,3638,40,80,40,40,1,0,0,0.5,50,40
54,3,3,3487,50,100,50,50,1,-10,10,0.6,50,60
54,4,4,3688,-60,0,60,60,1,20,20,0.583333333,-50,40
54,5,5,3282,35,60,25,35,1,-15,15,0.714285714,30,40
54,6,6,3545,-40,40,80,40,1,20,20,0.25,-50,60
54,7,7,3647,10,80,70,10,1,10,10,0,10,60
54,8,8,3847,-30,20,50,30,1,10,10,0.266666667,-30,40
54,9,9,3684,-50,20,70,50,1,10,10,0,-50,60
54,10,10,3509,10,80,70,10,1,10,10,1,10,60
54,11,11,3336,38,80,42,38,1,2,2,-0.315789474,30,40
54,12,12,4231,10,40,30,10,1,-10,10,2,10,40
54,13,13,3385,-40,40,80,40,1,20,20,0,-50,60
54,14,14,3553,-30,20,50,30,1,10,10,0,-30,40
54,15,15,4357,20,100,80,20,1,20,20,-0.75,10,60
54,16,16,3444,-50,0,50,50,1,10,10,0.2,-50,40
54,17,17,3821,-5,60,65,5,1,5,5,-1,-10,60
54,18,18,5520,-50,20,70,50,1,10,10,-0.2,-50,60
54,19,19,3749,20,60,40,20,1,0,0,-0.5,10,40
54,20,20,3746,50,80,30,50,1,-10,10,0.2,50,40
54,21,21,4262,20,100,80,20,1,20,20,-1,10,60
54,22,22,3841,20,80,60,20,1,0,0,-0.5,10,60
54,23,23,3851,-20,20,40,20,1,0,0,-0.5,-10,40
54,24,24,4289,-30,20,50,30,1,-10,10,0.166666667,-30,60
54,25,25,4093,-50,0,50,50,1,10,10,0.4,-50,40
54,26,26,3798,-5,40,45,5,1,-15,15,-6,-10,60
54,27,27,3919,30,60,30,30,1,-10,10,0.666666667,30,40
54,28,28,4051,-10,40,50,10,1,10,10,,-10,40
54,29,29,3343,-15,60,75,15,1,15,15,,-10,60
54,30,0,3842,20,40,20,20,0,-40,40,2,10,60
54,31,1,3715,0,40,40,0,0,0,0,,,40
54,32,2,3814,0,30,30,0,0,-10,10,,,40
54,33,3,3588,-10,50,60,10,0,0,0,-1,-10,60
54,34,4,3964,10,80,70,10,0,10,10,-2,10,60
54,35,5,4155,-20,20,40,20,0,0,0,0.5,-10,40
54,36,6,3937,20,50,30,20,0,-10,10,0.25,10,40
54,37,7,3916,10,60,50,10,0,-10,10,1,10,60
54,38,8,4360,25,60,35,25,0,-5,5,0.2,30,40
54,39,9,3988,10,70,60,10,0,0,0,0,10,60
54,40,10,4222,10,50,40,10,0,0,0,-1,10,40
54,41,11,4652,20,80,60,20,0,0,0,0.25,10,60
54,42,12,3464,-15,50,65,15,0,5,5,-0.666666667,-10,60
54,43,13,4215,30,60,30,30,0,-10,10,0.333333333,30,40
54,44,14,4787,-5,70,75,5,0,15,15,2,-10,60
54,45,15,4383,-20,20,40,20,0,0,0,0.25,-10,40
54,46,16,4217,-25,40,65,25,0,5,5,0,-30,60
54,47,17,4222,5,40,35,5,0,-5,5,-1,10,40
54,48,18,4206,-5,60,65,5,0,5,5,-2,-10,60
54,49,19,4149,0,30,30,0,0,-10,10,,,40
54,50,20,3867,-25,50,75,25,0,15,15,0.2,-30,60
54,51,21,3351,-10,60,70,10,0,10,10,-0.5,-10,60
54,52,22,3693,20,50,30,20,0,-10,10,0,10,40
54,53,23,4140,-10,20,30,10,0,-10,10,0,-10,40
54,54,24,3281,5,80,75,5,0,15,15,1,10,60
54,55,25,3944,30,60,30,30,0,-10,10,0.166666667,30,40
54,56,26,3359,-5,30,35,5,0,-5,5,2,-10,40
54,57,27,3743,-10,70,80,10,0,20,20,0.5,-10,60
54,58,28,4159,-35,40,75,35,0,15,15,,-30,60
54,59,29,3774,15,40,25,15,0,-15,15,,10,40
55,0,0,4176,10,80,70,10,1,30,30,-4,10,40
55,1,1,3616,80,100,20,80,1,-40,40,0.75,70,60
55,2,2,3689,-30,0,30,30,1,-10,10,0.333333333,-30,40
55,3,3,3307,-60,20,80,60,1,20,20,1,-50,60
55,4,4,3768,20,40,20,20,1,-20,20,0.5,10,40
55,5,5,3149,30,60,30,30,1,-10,10,1.333333333,30,40
55,6,6,3975,40,60,20,40,1,-40,40,0.75,50,60
55,7,7,3101,-10,40,50,10,1,-10,10,3,-10,60
55,8,8,3073,-50,20,70,50,1,30,30,-0.4,-50,40
55,9,9,3782,60,80,20,60,1,-40,40,0.5,50,60
55,10,10,4051,-30,20,50,30,1,-10,10,0,-30,60
55,11,11,3209,-90,0,90,90,1,50,50,0.777777778,-70,40
55,12,12,3516,60,80,20,60,1,-20,20,1,50,40
55,13,13,4083,10,60,50,10,1,-10,10,3,10,60
55,14,14,3702,-40,40,80,40,1,40,40,1.5,-50,40
55,15,15,3343,0,80,80,0,1,20,20,,,60
55,16,16,3351,0,20,20,0,1,-20,20,,,40
55,17,17,3665,30,40,10,30,1,-50,50,1.333333333,30,60
55,18,18,3020,50,100,50,50,1,-10,10,-0.6,50,60
55,19,19,3254,30,60,30,30,1,-10,10,1.666666667,30,40
55,20,20,3933,0,80,80,0,1,40,40,,,40
55,21,21,4041,80,100,20,80,1,-40,40,0.5,70,60
55,22,22,5016,-40,20,60,40,1,0,0,-0.25,-50,60
55,23,23,3485,20,40,20,20,1,-20,20,1,10,40
55,24,24,3262,10,80,70,10,1,10,10,-5,10,60
55,25,25,4002,-20,20,40,20,1,0,0,1.5,-10,40
55,26,26,4018,20,40,20,20,1,-40,40,3,10,60
55,27,27,3873,50,60,10,50,1,-30,30,0.2,50,40
55,28,28,3819,-20,0,20,20,1,-20,20,,-10,40
55,29,29,4133,-20,60,80,20,1,20,20,,-10,60
55,30,0,3436,-30,50,80,30,0,20,20,0,-30,60
55,31,1,3036,-10,40,50,10,0,10,10,1,-10,40
55,32,2,3935,10,50,40,10,0,0,0,0,10,40
55,33,3,3671,-40,40,80,40,0,20,20,0.5,-50,60
55,34,4,3200,10,70,60,10,0,0,0,-2,10,60
55,35,5,3078,-20,20,40,20,0,0,0,1,-10,40
55,36,6,3950,40,60,20,40,0,-20,20,0,50,40
55,37,7,3564,40,80,40,40,0,-20,20,1.25,50,60
55,38,8,2993,10,30,20,10,0,-20,20,1,10,40
55,39,9,3065,-30,60,90,30,0,30,30,0.666666667,-30,60
55,40,10,2977,-10,20,30,10,0,-10,10,2.8,-10,40
55,41,11,2957,-30,40,70,30,0,10,10,-0.333333333,-30,60
55,42,12,3036,-30,50,80,30,0,20,20,1,-30,60
55,43,13,3024,58,60,2,58,0,-38,38,0.482758621,50,40
55,44,14,3263,30,80,50,30,0,-10,10,0.666666667,30,60
55,45,15,2926,0,30,30,0,0,-10,10,,,40
55,46,16,2945,-10,60,70,10,0,10,10,0,-10,60
55,47,17,5329,10,50,40,10,0,0,0,-2,10,40
55,48,18,4304,0,70,70,0,0,10,10,,,60
55,49,19,4625,20,40,20,20,0,-20,20,2.5,10,40
55,50,20,3296,-30,50,80,30,0,20,20,0.666666667,-30,60
55,51,21,3202,20,80,60,20,0,0,0,1,10,60
55,52,22,3707,-50,20,70,50,0,30,30,0.8,-50,40
55,53,23,2866,10,40,30,10,0,-10,10,-1,10,40
55,54,24,2775,-40,40,80,40,0,20,20,0,-50,60
55,55,25,3905,30,50,20,30,0,-20,20,0,30,40
55,56,26,3327,40,60,20,40,0,-20,20,0,50,40
55,57,27,3336,-20,60,80,20,0,20,20,1,-10,60
55,58,28,4431,10,70,60,10,0,0,0,,10,60
55,59,29,3162,10,30,20,10,0,-20,20,,10,40
56,0,0,5220,-10,50,60,10,0,0,0,0,-10,60
56,1,1,5360,-10,20,30,10,0,-10,10,1,-10,40
56,2,2,4415,20,40,20,20,0,-20,20,1,10,40
56,3,3,4460,10,70,60,10,0,0,0,0,10,60
56,4,4,4162,-20,40,60,20,0,0,0,2.85,-10,60
56,5,5,5197,10,50,40,10,0,0,0,-2,10,40
56,6,6,4399,40,60,20,40,0,-20,20,0,50,40
56,7,7,7022,77,80,3,77,0,-57,57,1,70,60
56,8,8,3988,10,30,20,10,0,-20,20,0,10,40
56,9,9,3948,-20,60,80,20,0,20,20,2,-10,60
56,10,10,4644,0,20,20,0,0,-20,20,,,40
56,11,11,5048,0,40,40,0,0,-20,20,,,60
56,12,12,3954,10,60,50,10,0,-10,10,1,10,60
56,13,13,4282,30,40,10,30,0,-30,30,0,30,40
56,14,14,4011,10,70,60,10,0,0,0,0,10,60
56,15,15,4022,50,60,10,50,0,-30,30,1,50,40
56,16,16,4127,20,80,60,20,0,0,0,-2,10,60
56,17,17,6028,-30,30,60,30,0,20,20,1.666666667,-30,40
56,18,18,4298,30,50,20,30,0,-40,40,0.666666667,30,60
56,19,19,5176,40,50,10,40,0,-30,30,0.5,50,40
56,20,20,4943,30,70,40,30,0,-20,20,0,30,60
56,21,21,4115,40,80,40,40,0,-20,20,0.5,50,60
56,22,22,5516,10,40,30,10,0,-10,10,-1,10,40
56,23,23,4843,0,20,20,0,0,-20,20,,,40
56,24,24,3899,-10,50,60,10,0,0,0,1,-10,60
56,25,25,4430,20,30,10,20,0,-30,30,1,10,40
56,26,26,5119,30,60,30,30,0,-10,10,0,30,40
56,27,27,3947,-10,40,50,10,0,-10,10,-3,-10,60
56,28,28,3556,-20,60,80,20,0,20,20,,-10,60
56,29,29,5024,20,50,30,20,0,-10,10,,10,40
56,30,0,5056,-30,20,50,30,1,10,10,0.333333333,-30,40
56,31,1,4509,-10,40,50,10,1,-10,10,1,-10,60
56,32,2,6055,0,40,40,0,1,0,0,,,40
56,33,3,4569,20,60,40,20,1,-20,20,0,10,60
56,34,4,4100,20,60,40,20,1,0,0,-0.5,10,40
56,35,5,3912,-30,0,30,30,1,-10,10,0.333333333,-30,40
56,36,6,3735,40,80,40,40,1,-20,20,0.75,50,60
56,37,7,3397,30,100,70,30,1,10,10,-0.333333333,30,60
56,38,8,4516,60,80,20,60,1,-20,20,0.5,50,40
56,39,9,4865,-40,20,60,40,1,0,0,0.5,-50,60
56,40,10,6132,20,60,40,20,1,-20,20,0.5,10,60
56,41,11,4643,-30,20,50,30,1,10,10,1.333333333,-30,40
56,42,12,4885,50,60,10,50,1,-30,30,0,50,40
56,43,13,4554,-30,20,50,30,1,-10,10,0.333333333,-30,60
56,44,14,3919,70,80,10,70,1,-30,30,0.428571429,70,40
56,45,15,4302,0,40,40,0,1,-20,20,,,60
56,46,16,5739,0,40,40,0,1,0,0,,,40
56,47,17,5802,70,100,30,70,1,-30,30,0.571428571,70,60
56,48,18,5299,10,80,70,10,1,10,10,3,10,60
56,49,19,3975,-60,0,60,60,1,20,20,1,-50,40
56,50,20,5024,60,60,0,60,1,-40,40,0.5,50,40
56,51,21,6229,-20,80,100,20,1,40,40,1.5,-10,60
56,52,22,4833,-30,40,70,30,1,10,10,2.333333333,-30,60
56,53,23,4933,-10,20,30,10,1,-10,10,-2,-10,40
56,54,24,3100,60,60,0,60,1,-60,60,0.333333333,50,60
56,55,25,3860,30,80,50,30,1,10,10,0,30,40
56,56,26,4038,80,100,20,80,1,-40,40,0.25,70,60
56,57,27,4486,-50,0,50,50,1,10,10,0.4,-50,40
56,58,28,5206,10,40,30,10,1,-10,10,,10,40
56,59,29,5282,-20,20,40,20,1,-20,20,,-10,60
57,0,0,4247,-10,50,60,10,0,0,0,-1,-10,60
57,1,1,3230,-40,20,60,40,0,20,20,0.75,-50,40
57,2,2,4358,10,40,30,10,0,-10,10,0.5,10,40
57,3,3,3642,0,70,70,0,0,10,10,,,60
57,4,4,3671,-30,40,70,30,0,10,10,0.333333333,-30,60
57,5,5,2566,15,50,35,15,0,-5,5,0,10,40
57,6,6,3463,-5,30,35,5,0,-5,5,0,-10,40
57,7,7,3367,0,60,60,0,0,0,0,,,60
57,8,8,2940,25,60,35,25,0,-5,5,0.2,30,40
57,9,9,4088,20,80,60,20,0,0,0,0.25,10,60
57,10,10,3231,-20,20,40,20,0,0,0,0,-10,40
57,11,11,3715,5,70,65,5,0,5,5,1,10,60
57,12,12,4478,-20,50,70,20,0,10,10,0,-10,60
57,13,13,3425,20,60,40,20,0,0,0,0,10,40
57,14,14,4436,-10,60,70,10,0,10,10,0.5,-10,60
57,15,15,3053,10,50,40,10,0,0,0,-3.6,10,40
57,16,16,3300,-25,40,65,25,0,5,5,0,-30,60
57,17,17,7005,36,40,4,36,0,-36,36,0.861111111,30,40
57,18,18,3818,15,80,65,15,0,5,5,0.333333333,10,60
57,19,19,3208,-5,30,35,5,0,-5,5,-1,-10,40
57,20,20,3286,-10,60,70,10,0,10,10,0,-10,60
57,21,21,3226,-30,40,70,30,0,10,10,0.166666667,-30,60
57,22,22,3025,0,40,40,0,0,0,0,,,40
57,23,23,3352,-20,20,40,20,0,0,0,0,-10,40
57,24,24,3269,5,70,65,5,0,5,5,0,10,60
57,25,25,3151,20,60,40,20,0,0,0,0.25,10,40
57,26,26,2947,5,50,45,5,0,5,5,-1,10,40
57,27,27,3077,15,80,65,15,0,5,5,0,10,60
57,28,28,3157,-15,50,65,15,0,5,5,,-10,60
57,29,29,3164,-10,30,40,10,0,0,0,,-10,40
57,30,0,3857,30,80,50,30,1,10,10,0.333333333,30,40
57,31,1,3226,-10,40,50,10,1,-10,10,0,-10,60
57,32,2,3760,-40,20,60,40,1,20,20,0.25,-50,40
57,33,3,3409,30,80,50,30,1,-10,10,0.166666667,30,60
57,34,4,3578,-50,0,50,50,1,10,10,0.2,-50,40
57,35,5,3258,20,60,40,20,1,0,0,0,10,40
57,36,6,3854,45,100,55,45,1,-5,5,0.111111111,50,60
57,37,7,3270,-40,20,60,40,1,0,0,0,-50,60
57,38,8,3588,0,40,40,0,1,0,0,,,40
57,39,9,3142,0,60,60,0,1,0,0,,,60
57,40,10,3295,0,60,60,0,1,0,0,,,60
57,41,11,3196,20,60,40,20,1,0,0,1,10,40
57,42,12,3203,20,80,60,20,1,20,20,-0.75,10,40
57,43,13,4199,60,100,40,60,1,-20,20,0.416666667,50,60
57,44,14,5140,-45,0,45,45,1,5,5,0.111111111,-50,40
57,45,15,3025,-25,40,65,25,1,5,5,0,-30,60
57,46,16,3211,0,40,40,0,1,0,0,,,40
57,47,17,3875,-45,20,65,45,1,5,5,0.111111111,-50,60
57,48,18,3128,20,80,60,20,1,0,0,0,10,60
57,49,19,3208,-20,20,40,20,1,0,0,0,-10,40
57,50,20,3236,0,40,40,0,1,0,0,,,40
57,51,21,3171,-40,20,60,40,1,0,0,0.125,-50,60
57,52,22,3017,45,100,55,45,1,-5,5,0.111111111,50,60
57,53,23,3107,-20,20,40,20,1,0,0,0,-10,40
57,54,24,3099,0,60,60,0,1,0,0,,,60
57,55,25,3905,40,80,40,40,1,0,0,0,50,40
57,56,26,3116,20,80,60,20,1,0,0,0,10,60
57,57,27,4035,20,60,40,20,1,0,0,0,10,40
57,58,28,3152,-40,0,40,40,1,0,0,,-50,40
57,59,29,6041,-20,40,60,20,1,0,0,,-10,60
58,0,0,5566,-30,60,90,30,1,50,50,0,-30,40
58,1,1,4755,-10,20,30,10,1,-30,30,0,-10,60
58,2,2,4866,-70,20,90,70,1,50,50,0.857142857,-70,40
58,3,3,5273,70,100,30,70,1,-30,30,0.571428571,70,60
58,4,4,4923,-30,0,30,30,1,-10,10,0.333333333,-30,40
58,5,5,5278,20,40,20,20,1,-20,20,0,10,40
58,6,6,5105,10,80,70,10,1,10,10,0,10,60
58,7,7,5211,-10,60,70,10,1,10,10,1,-10,60
58,8,8,4640,60,80,20,60,1,-20,20,0.333333333,50,40
58,9,9,4878,-20,40,60,20,1,0,0,0,-10,60
58,10,10,4847,-40,20,60,40,1,0,0,0,-50,60
58,11,11,5285,-20,20,40,20,1,0,0,1,-10,40
58,12,12,5282,20,40,20,20,1,-20,20,1,10,40
58,13,13,4713,-20,40,60,20,1,0,0,0.5,-10,60
58,14,14,5076,-40,0,40,40,1,0,0,0.5,-50,40
58,15,15,5346,50,100,50,50,1,-10,10,0.2,50,60
58,16,16,4546,40,60,20,40,1,-20,20,0,50,40
58,17,17,4745,0,60,60,0,1,0,0,,,60
58,18,18,6339,20,80,60,20,1,0,0,1,10,60
58,19,19,5165,60,80,20,60,1,-20,20,0,50,40
58,20,20,4920,40,60,20,40,1,-20,20,0,50,40
58,21,21,5027,20,100,80,20,1,20,20,-1,10,60
58,22,22,4805,-20,40,60,20,1,0,0,-0.5,-10,60
58,23,23,5196,60,80,20,60,1,-20,20,-0.333333333,50,40
58,24,24,4587,-50,20,70,50,1,10,10,0,-50,60
58,25,25,4536,20,20,0,20,1,-40,40,3,10,40
58,26,26,3719,-10,60,70,10,1,10,10,-1,-10,60
58,27,27,4696,-60,0,60,60,1,20,20,1,-50,40
58,28,28,4404,40,40,0,40,1,-40,40,,50,40
58,29,29,4779,0,80,80,0,1,20,20,,,60
58,30,0,7003,-40,40,80,40,0,20,20,0.5,-50,60
58,31,1,6551,-60,20,80,60,0,40,40,0.666666667,-50,40
58,32,2,6578,-10,30,40,10,0,0,0,2,-10,40
58,33,3,7002,-10,50,60,10,0,0,0,1,-10,60
58,34,4,6599,20,70,50,20,0,-10,10,1,10,60
58,35,5,6774,20,40,20,20,0,-20,20,1,10,40
58,36,6,6691,10,50,40,10,0,0,0,0,10,40
58,37,7,6423,-10,60,70,10,0,10,10,-1,-10,60
58,38,8,6277,20,60,40,20,0,0,0,0,10,40
58,39,9,6042,0,80,80,0,0,20,20,,,60
58,40,10,5773,20,60,40,20,0,0,0,-0.5,10,40
58,41,11,6053,-10,60,70,10,0,10,10,-1,-10,60
58,42,12,6303,-40,40,80,40,0,20,20,0,-50,60
58,43,13,5890,-10,20,30,10,0,-10,10,0,-10,40
58,44,14,5205,0,80,80,0,0,20,20,,,60
58,45,15,5818,0,30,30,0,0,-10,10,,,40
58,46,16,5164,-30,50,80,30,0,20,20,1,-30,60
58,47,17,5773,20,40,20,20,0,-20,20,1.5,10,40
58,48,18,5188,20,70,50,20,0,-10,10,1.5,10,60
58,49,19,6113,0,50,50,0,0,10,10,,,40
58,50,20,5989,0,80,80,0,0,20,20,,,60
58,51,21,5773,-40,60,100,40,0,40,40,0.5,-50,60
58,52,22,5343,0,40,40,0,0,0,0,,,40
58,53,23,5225,-10,20,30,10,0,-10,10,1,-10,40
58,54,24,4633,-40,40,80,40,0,20,20,0.25,-50,60
58,55,25,5422,40,60,20,40,0,-20,20,0.75,50,40
58,56,26,5325,0,50,50,0,0,10,10,,,40
58,57,27,5350,-20,50,70,20,0,10,10,0.5,-10,60
58,58,28,5562,10,70,60,10,0,0,0,,10,60
58,59,29,5634,-10,30,40,10,0,0,0,,-10,40
59,0,0,5097,-10,20,30,10,1,-10,10,0,-10,40
59,1,1,4616,20,80,60,20,1,0,0,0.5,10,60
59,2,2,5320,-30,0,30,30,1,-10,10,0.5,-30,40
59,3,3,4488,-10,60,70,10,1,10,10,-1,-10,60
59,4,4,4791,25,40,15,25,1,-25,25,0.2,30,40
59,5,5,4753,40,60,20,40,1,-20,20,-0.5,50,40
59,6,6,4682,-40,40,80,40,1,20,20,0.5,-50,60
59,7,7,5072,40,100,60,40,1,0,0,-0.5,50,60
59,8,8,5184,80,80,0,80,1,-40,40,0.625,70,40
59,9,9,4842,-20,20,40,20,1,-20,20,-0.5,-10,60
59,10,10,4417,-30,20,50,30,1,-10,10,0,-30,60
59,11,11,4543,-50,0,50,50,1,10,10,0.4,-50,40
59,12,12,5081,50,80,30,50,1,-10,10,0.4,50,40
59,13,13,4625,30,80,50,30,1,-10,10,0.333333333,30,60
59,14,14,5121,-10,40,50,10,1,10,10,4,-10,40
59,15,15,4929,-20,40,60,20,1,0,0,-1.5,-10,60
59,16,16,5042,50,60,10,50,1,-30,30,0.6,50,40
59,17,17,5001,10,100,90,10,1,30,30,-1,10,60
59,18,18,4784,-20,60,80,20,1,20,20,2,-10,60
59,19,19,5336,-20,20,40,20,1,0,0,2,-10,40
59,20,20,4345,60,60,0,60,1,-40,40,0.666666667,50,40
59,21,21,4953,40,80,40,40,1,-20,20,0,50,60
59,22,22,4392,60,100,40,60,1,-20,20,-0.333333333,50,60
59,23,23,4936,-20,20,40,20,1,0,0,-1,-10,40
59,24,24,4897,0,20,20,0,1,-40,40,,,60
59,25,25,4298,-20,40,60,20,1,20,20,0.5,-10,40
59,26,26,4513,-20,60,80,20,1,20,20,1.5,-10,60
59,27,27,5304,-50,0,50,50,1,10,10,-0.2,-50,40
59,28,28,4705,20,80,60,20,1,20,20,,10,40
59,29,29,5185,-10,40,50,10,1,-10,10,,-10,60
59,30,0,3314,20,70,50,20,0,-10,10,2,10,60
59,31,1,3649,0,20,20,0,0,-20,20,,,40
59,32,2,4472,0,30,30,0,0,-10,10,,,40
59,33,3,4497,-10,80,90,10,0,30,30,0,-10,60
59,34,4,5049,-30,60,90,30,0,30,30,0.333333333,-30,60
59,35,5,4056,10,50,40,10,0,0,0,-3,10,40
59,36,6,4177,30,40,10,30,0,-30,30,0,30,40
59,37,7,4344,-40,40,80,40,0,20,20,0.25,-50,60
59,38,8,4833,50,60,10,50,0,-30,30,0.2,50,40
59,39,9,4489,-20,50,70,20,0,10,10,-0.5,-10,60
59,40,10,4249,10,30,20,10,0,-20,20,2,10,40
59,41,11,4552,-20,60,80,20,0,20,20,0.5,-10,60
59,42,12,4689,0,70,70,0,0,10,10,,,60
59,43,13,4192,-20,20,40,20,0,0,0,0.5,-10,40
59,44,14,4776,20,80,60,20,0,0,0,1,10,60
59,45,15,4481,10,40,30,10,0,-10,10,0,10,40
59,46,16,4337,-30,50,80,30,0,20,20,0,-30,60
59,47,17,4440,20,50,30,20,0,-10,10,-1,10,40
59,48,18,4904,-40,40,80,40,0,20,20,0.25,-50,60
59,49,19,4272,50,60,10,50,0,-30,30,0.6,50,40
59,50,20,4385,-20,50,70,20,0,10,10,0.5,-10,60
59,51,21,4329,-20,40,60,20,0,0,0,0,-10,60
59,52,22,5161,10,50,40,10,0,0,0,1,10,40
59,53,23,5418,-10,40,50,10,0,10,10,1,-10,40
59,54,24,4745,20,80,60,20,0,0,0,-0.5,10,60
59,55,25,4984,-20,20,40,20,0,0,0,0,-10,40
59,56,26,4768,-10,30,40,10,0,0,0,0,-10,40
59,57,27,4473,20,70,50,20,0,-10,10,0.5,10,60
59,58,28,5487,0,60,60,0,0,0,0,,,60
59,59,29,5017,20,60,40,20,0,0,0,,10,40
60,0,0,5866,0,50,50,0,0,-10,10,,,60
60,1,1,4441,10,60,50,10,0,10,10,1,10,40
60,2,2,4663,-20,40,60,20,0,20,20,0.5,-10,40
60,3,3,5310,30,80,50,30,0,-10,10,1,30,60
60,4,4,5474,-40,40,80,40,0,20,20,0.75,-50,60
60,5,5,5840,-20,30,50,20,0,10,10,0,-10,40
60,6,6,2904,0,50,50,0,0,10,10,,,40
60,7,7,2794,10,60,50,10,0,-10,10,-4.5,10,60
60,8,8,5008,-40,20,60,40,0,20,20,0.25,-50,40
60,9,9,3410,65,70,5,65,0,-55,55,0.846153846,70,60
60,10,10,3047,-30,20,50,30,0,10,10,0,-30,40
60,11,11,3591,-10,50,60,10,0,0,0,2,-10,60
60,12,12,3121,0,40,40,0,0,-20,20,,,60
60,13,13,2939,-20,30,50,20,0,10,10,0.5,-10,40
60,14,14,2685,20,70,50,20,0,-10,10,0.5,10,60
60,15,15,2868,10,50,40,10,0,0,0,-1,10,40
60,16,16,3120,0,60,60,0,0,0,0,,,60
60,17,17,2794,30,60,30,30,0,-10,10,0.666666667,30,40
60,18,18,2722,20,80,60,20,0,0,0,-0.5,10,60
60,19,19,2886,-10,40,50,10,0,10,10,1,-10,40
60,20,20,2814,-10,40,50,10,0,-10,10,-3,-10,60
60,21,21,2757,-10,70,80,10,0,20,20,5,-10,60
60,22,22,2687,-20,20,40,20,0,0,0,0.5,-10,40
60,23,23,2710,20,50,30,20,0,-10,10,1,10,40
60,24,24,2685,50,80,30,50,0,-30,30,0.4,50,60
60,25,25,2722,-10,40,50,10,0,10,10,2,-10,40
60,26,26,2685,30,60,30,30,0,-10,10,0.333333333,30,40
60,27,27,3580,10,60,50,10,0,-10,10,0,10,60
60,28,28,2649,0,50,50,0,0,-10,10,,,60
60,29,29,2650,-10,30,40,10,0,0,0,,-10,40
60,30,0,2908,-20,40,60,20,1,20,20,0.5,-10,40
60,31,1,2795,30,80,50,30,1,-10,10,0.333333333,30,60
60,32,2,2686,-30,20,50,30,1,10,10,0,-30,40
60,33,3,2758,-40,20,60,40,1,0,0,-0.75,-50,60
60,34,4,2779,30,80,50,30,1,10,10,0,30,40
60,35,5,3630,-50,0,50,50,1,10,10,0.8,-50,40
60,36,6,2948,10,100,90,10,1,30,30,-4,10,60
60,37,7,2685,10,60,50,10,1,-10,10,1,10,60
60,38,8,3265,50,60,10,50,1,-30,30,1.4,50,40
60,39,9,2711,-20,40,60,20,1,0,0,1.5,-10,60
60,40,10,2694,-10,20,30,10,1,-30,30,-1,-10,60
60,41,11,2649,-40,40,80,40,1,40,40,0.75,-50,40
60,42,12,3121,-50,0,50,50,1,10,10,0,-50,40
60,43,13,2649,0,40,40,0,1,-20,20,,,60
60,44,14,2685,30,80,50,30,1,10,10,0.333333333,30,40
60,45,15,2797,50,100,50,50,1,-10,10,-0.2,50,60
60,46,16,2682,-40,20,60,40,1,20,20,0.25,-50,40
60,47,17,2760,20,60,40,20,1,-20,20,2.5,10,60
60,48,18,4629,-10,80,90,10,1,30,30,7,-10,60
60,49,19,2796,10,60,50,10,1,10,10,-2,10,40
60,50,20,2781,30,60,30,30,1,-10,10,0,30,40
60,51,21,3011,40,60,20,40,1,-40,40,0.75,50,60
60,52,22,2939,-10,40,50,10,1,-10,10,3,-10,60
60,53,23,2722,10,40,30,10,1,-10,10,2,10,40
60,54,24,2832,0,20,20,0,1,-40,40,,,60
60,55,25,2686,30,80,50,30,1,10,10,1,30,40
60,56,26,2722,70,100,30,70,1,-30,30,0,70,60
60,57,27,3067,-80,0,80,80,1,40,40,0.375,-70,40
60,58,28,2649,-30,20,50,30,1,10,10,,-30,40
60,59,29,2757,50,80,30,50,1,-30,30,,50,60
61,0,0,6942,0,40,40,0,0,-20,20,,,60
61,1,1,3731,-10,30,40,10,0,0,0,0,-10,40
61,2,2,4051,10,50,40,10,0,0,0,0,10,40
61,3,3,3580,30,70,40,30,0,-20,20,-1.333333333,30,60
61,4,4,7011,80,80,0,80,0,-60,60,0.5,70,60
61,5,5,3684,20,60,40,20,0,0,0,1,10,40
61,6,6,7007,-20,40,60,20,0,20,20,0.5,-10,40
61,7,7,4835,10,50,40,10,0,-20,20,1,10,60
61,8,8,5052,-30,20,50,30,0,10,10,1,-30,40
61,9,9,4745,10,60,50,10,0,-10,10,0,10,60
61,10,10,4322,0,20,20,0,0,-20,20,,,40
61,11,11,5215,0,50,50,0,0,-10,10,,,60
61,12,12,5389,20,80,60,20,0,0,0,-0.5,10,60
61,13,13,6051,-10,40,50,10,0,10,10,3,-10,40
61,14,14,5229,-10,40,50,10,0,-10,10,0,-10,60
61,15,15,5043,30,50,20,30,0,-20,20,1,30,40
61,16,16,5681,20,70,50,20,0,-10,10,-0.5,10,60
61,17,17,5518,10,60,50,10,0,10,10,-1,10,40
61,18,18,5973,20,60,40,20,0,-20,20,0,10,60
61,19,19,5556,-10,30,40,10,0,0,0,-1,-10,40
61,20,20,4857,20,60,40,20,0,-20,20,1,10,60
61,21,21,5565,-10,50,60,10,0,0,0,0,-10,60
61,22,22,4687,0,50,50,0,0,10,10,,,40
61,23,23,4716,0,40,40,0,0,0,0,,,40
61,24,24,4268,-20,40,60,20,0,0,0,0,-10,60
61,25,25,5855,10,60,50,10,0,10,10,1,10,40
61,26,26,4688,-40,20,60,40,0,20,20,0.25,-50,40
61,27,27,4822,10,70,60,10,0,0,0,0,10,60
61,28,28,4962,20,80,60,20,0,0,0,,10,60
61,29,29,5734,-20,30,50,20,0,10,10,,-10,40
61,30,0,5065,40,80,40,40,1,0,0,0,50,40
61,31,1,4917,60,100,40,60,1,-20,20,0.333333333,50,60
61,32,2,4938,-20,20,40,20,1,0,0,0,-10,40
61,33,3,5496,0,60,60,0,1,0,0,,,60
61,34,4,4482,20,60,40,20,1,0,0,0.5,10,40
61,35,5,3867,-10,40,50,10,1,10,10,1,-10,40
61,36,6,4887,-40,20,60,40,1,0,0,0,-50,60
61,37,7,4889,20,80,60,20,1,0,0,-1,10,60
61,38,8,5047,-40,0,40,40,1,0,0,0.5,-50,40
61,39,9,3805,0,40,40,0,1,-20,20,,,60
61,40,10,4422,-20,20,40,20,1,-20,20,-0.5,-10,60
61,41,11,4750,0,20,20,0,1,-20,20,,,40
61,42,12,4548,-30,0,30,30,1,-10,10,0.333333333,-30,40
61,43,13,4918,50,100,50,50,1,-10,10,1,50,60
61,44,14,4998,60,80,20,60,1,-20,20,0.5,50,40
61,45,15,4866,-20,80,100,20,1,40,40,1,-10,60
61,46,16,4540,10,60,50,10,1,10,10,-3,10,40
61,47,17,4966,-20,60,80,20,1,20,20,0,-10,60
61,48,18,4900,-40,40,80,40,1,20,20,0.5,-50,60
61,49,19,4220,20,40,20,20,1,-20,20,0,10,40
61,50,20,3940,40,60,20,40,1,-20,20,1,50,40
61,51,21,3890,-20,40,60,20,1,0,0,1,-10,60
61,52,22,4293,40,80,40,40,1,-20,20,1,50,60
61,53,23,4172,20,80,60,20,1,20,20,-2,10,40
61,54,24,4122,20,100,80,20,1,20,20,0,10,60
61,55,25,4792,-20,0,20,20,1,-20,20,0,-10,40
61,56,26,4153,-60,20,80,60,1,20,20,0.666666667,-50,60
61,57,27,4075,20,40,20,20,1,-20,20,0,10,40
61,58,28,4247,0,20,20,0,1,-20,20,,,40
61,59,29,3991,20,60,40,20,1,-20,20,,10,60
62,0,0,3343,-10,60,70,10,1,30,30,1,-10,40
62,1,1,3411,50,80,30,50,1,-30,30,1,50,60
62,2,2,4099,-60,0,60,60,1,20,20,0.5,-50,40
62,3,3,3686,-60,20,80,60,1,20,20,0.5,-50,60
62,4,4,5076,50,80,30,50,1,-10,10,0.8,50,40
62,5,5,3238,-50,20,70,50,1,30,30,0.4,-50,40
62,6,6,3644,10,60,50,10,1,-10,10,1,10,60
62,7,7,3182,40,100,60,40,1,0,0,0.25,50,60
62,8,8,3131,-10,40,50,10,1,10,10,0,-10,40
62,9,9,3653,-30,40,70,30,1,10,10,0.333333333,-30,60
62,10,10,3275,-40,20,60,40,1,0,0,-0.75,-50,60
62,11,11,3277,30,80,50,30,1,10,10,1,30,40
62,12,12,3724,-80,0,80,80,1,40,40,0.75,-70,40
62,13,13,3632,-10,80,90,10,1,30,30,1,-10,60
62,14,14,3584,0,20,20,0,1,-20,20,,,40
62,15,15,3748,20,100,80,20,1,20,20,-2,10,60
62,16,16,3013,-20,60,80,20,1,40,40,3,-10,40
62,17,17,3262,20,60,40,20,1,-20,20,2.5,10,60
62,18,18,3545,-50,40,90,50,1,30,30,-0.2,-50,60
62,19,19,3583,20,40,20,20,1,-20,20,0,10,40
62,20,20,3081,20,40,20,20,1,-20,20,0,10,40
62,21,21,3520,-20,80,100,20,1,40,40,0.5,-10,60
62,22,22,3218,-30,60,90,30,1,30,30,0,-30,60
62,23,23,3631,60,80,20,60,1,-20,20,0,50,40
62,24,24,3282,-70,20,90,70,1,30,30,-0.142857143,-70,60
62,25,25,3307,0,20,20,0,1,-20,20,,,40
62,26,26,3374,0,100,100,0,1,40,40,,,60
62,27,27,3369,30,60,30,30,1,-10,10,0.333333333,30,40
62,28,28,4101,-40,0,40,40,1,0,0,,-50,40
62,29,29,3312,-40,40,80,40,1,20,20,,-50,60
62,30,0,3167,55,80,25,55,0,-35,35,0.909090909,50,60
62,31,1,3426,15,40,25,15,0,-15,15,0.666666667,10,40
62,32,2,3405,-5,30,35,5,0,-5,5,1,-10,40
62,33,3,3285,-5,70,75,5,0,15,15,-1,-10,60
62,34,4,3539,-20,60,80,20,0,20,20,-0.5,-10,60
62,35,5,3190,-10,20,30,10,0,-10,10,-1,-10,40
62,36,6,3331,10,50,40,10,0,0,0,0,10,40
62,37,7,3267,-40,50,90,40,0,30,30,0.375,-50,60
62,38,8,3495,20,60,40,20,0,0,0,0,10,40
62,39,9,3567,-35,40,75,35,0,15,15,-0.142857143,-30,60
62,40,10,3188,0,40,40,0,0,0,0,,,40
62,41,11,3167,0,80,80,0,0,20,20,,,60
62,42,12,3136,-10,70,80,10,0,20,20,0,-10,60
62,43,13,3175,-10,30,40,10,0,0,0,0,-10,40
62,44,14,3457,-30,50,80,30,0,20,20,0,-30,60
62,45,15,3515,-20,20,40,20,0,0,0,0.5,-10,40
62,46,16,3222,-20,60,80,20,0,20,20,0,-10,60
62,47,17,3083,20,50,30,20,0,-10,10,0.5,10,40
62,48,18,3135,-40,40,80,40,0,20,20,-0.25,-50,60
62,49,19,3237,20,60,40,20,0,0,0,-1,10,40
62,50,20,3148,-40,50,90,40,0,30,30,0.5,-50,60
62,51,21,4307,10,80,70,10,0,10,10,0,10,60
62,52,22,3479,40,60,20,40,0,-20,20,0.75,50,40
62,53,23,3712,-30,20,50,30,0,10,10,0,-30,40
62,54,24,3576,-30,40,70,30,0,10,10,0.333333333,-30,60
62,55,25,3908,-10,40,50,10,0,10,10,1,-10,40
62,56,26,3887,-10,30,40,10,0,0,0,-2,-10,40
62,57,27,3791,0,60,60,0,0,0,0,,,60
62,58,28,3297,-10,70,80,10,0,20,20,,-10,60
62,59,29,3279,-10,50,60,10,0,20,20,,-10,40
63,0,0,7010,20,70,50,20,0,-10,10,0.5,10,60
63,1,1,7003,0,50,50,0,0,10,10,,,40
63,2,2,7005,0,60,60,0,0,20,20,,,40
63,3,3,7005,20,80,60,20,0,0,0,1.5,10,60
63,4,4,7003,-50,40,90,50,0,30,30,0.2,-50,60
63,5,5,7003,-10,20,30,10,0,-10,10,-2,-10,40
63,6,6,7011,-10,40,50,10,0,10,10,-1,-10,40
63,7,7,3470,-30,50,80,30,0,20,20,0.333333333,-30,60
63,8,8,2883,-30,30,60,30,0,20,20,1.333333333,-30,40
63,9,9,2870,-10,60,70,10,0,10,10,1,-10,60
63,10,10,3097,10,30,20,10,0,-20,20,2,10,40
63,11,11,2849,10,70,60,10,0,0,0,2,10,60
63,12,12,2934,-20,60,80,20,0,20,20,1,-10,60
63,13,13,2815,10,50,40,10,0,0,0,-1,10,40
63,14,14,2904,-10,50,60,10,0,0,0,-1,-10,60
63,15,15,2793,30,60,30,30,0,-10,10,-0.333333333,30,40
63,16,16,3096,-30,40,70,30,0,10,10,0,-30,60
63,17,17,2989,20,40,20,20,0,-20,20,0,10,40
63,18,18,2887,10,80,70,10,0,10,10,-1,10,60
63,19,19,3216,0,20,20,0,0,-20,20,,,40
63,20,20,2798,0,60,60,0,0,0,0,,,60
63,21,21,3774,-30,40,70,30,0,10,10,-0.333333333,-30,60
63,22,22,4408,0,30,30,0,0,-10,10,,,40
63,23,23,2903,-20,20,40,20,0,0,0,0.5,-10,40
63,24,24,3336,-10,70,80,10,0,20,20,0,-10,60
63,25,25,3368,20,50,30,20,0,-10,10,0.5,10,40
63,26,26,3222,20,60,40,20,0,0,0,-0.5,10,40
63,27,27,3508,0,80,80,0,0,20,20,,,60
63,28,28,2934,-10,50,60,10,0,0,0,,-10,60
63,29,29,7004,10,40,30,10,0,-10,10,,10,40
63,30,0,3981,0,60,60,0,1,20,20,,,40
63,31,1,3160,-20,20,40,20,1,-20,20,0.5,-10,60
63,32,2,2830,-30,40,70,30,1,30,30,-0.333333333,-30,40
63,33,3,3882,30,60,30,30,1,-30,30,0,30,60
63,34,4,3917,-60,20,80,60,1,40,40,0.333333333,-50,40
63,35,5,3341,20,80,60,20,1,20,20,0,10,40
63,36,6,3615,50,80,30,50,1,-30,30,0.4,50,60
63,37,7,3492,-10,40,50,10,1,-10,10,3,-10,60
63,38,8,2828,-60,0,60,60,1,20,20,0.5,-50,40
63,39,9,3156,80,100,20,80,1,-40,40,0.125,70,60
63,40,10,4207,50,80,30,50,1,-30,30,0.6,50,60
63,41,11,2972,10,40,30,10,1,-10,10,0,10,40
63,42,12,3254,-10,20,30,10,1,-10,10,0,-10,40
63,43,13,2995,-20,40,60,20,1,0,0,0,-10,60
63,44,14,2839,50,80,30,50,1,-10,10,0.2,50,40
63,45,15,2756,0,60,60,0,1,0,0,,,60
63,46,16,2985,-40,0,40,40,1,0,0,0,-50,40
63,47,17,4434,40,100,60,40,1,0,0,0,50,60
63,48,18,7007,-40,20,60,40,1,0,0,0,-50,60
63,49,19,3459,20,60,40,20,1,0,0,1,10,40
63,50,20,4690,-40,20,60,40,1,20,20,0.5,-50,40
63,51,21,2861,20,80,60,20,1,0,0,0,10,60
63,52,22,2823,-40,20,60,40,1,0,0,,-50,60
63,53,23,3239,-40,0,40,40,1,0,0,-0.5,-50,40
63,54,24,3708,,100,,,1,,,,,60
63,55,25,2960,-20,40,60,20,1,20,20,2,-10,40
63,56,26,4100,10,60,50,10,1,-10,10,2,10,60
63,57,27,2638,40,60,20,40,1,-20,20,0,50,40
63,58,28,2741,60,80,20,60,1,-20,20,,50,40
63,59,29,3689,-30,40,70,30,1,10,10,,-30,60
64,0,0,3810,10,60,50,10,0,-10,10,2,10,60
64,1,1,3918,10,50,40,10,0,0,0,0.5,10,40
64,2,2,3673,-15,30,45,15,0,5,5,0.666666667,-10,40
64,3,3,5282,-20,50,70,20,0,10,10,0.75,-10,60
64,4,4,3481,-15,40,55,15,0,-5,5,-0.666666667,-10,60
64,5,5,3504,5,40,35,5,0,-5,5,-0.4,10,40
64,6,6,3333,-13,20,33,13,0,-7,7,0.615384615,-10,40
64,7,7,3362,5,70,65,5,0,5,5,0,10,60
64,8,8,3386,35,60,25,35,0,-15,15,0.542857143,30,40
64,9,9,3933,15,80,65,15,0,5,5,0,10,60
64,10,10,3946,-24,20,44,24,0,4,4,0,-30,40
64,11,11,3186,-5,60,65,5,0,5,5,2,-10,60
64,12,12,3839,15,70,55,15,0,-5,5,1.333333333,10,60
64,13,13,4817,-4,40,44,4,0,4,4,2.25,-10,40
64,14,14,3711,-35,40,75,35,0,15,15,0.571428571,-30,60
64,15,15,3142,15,50,35,15,0,-5,5,0.666666667,10,40
64,16,16,2955,25,80,55,25,0,-5,5,-0.12,30,60
64,17,17,3212,-15,30,45,15,0,5,5,0.2,-10,40
64,18,18,3419,-2,50,52,2,0,-8,8,3.5,-10,60
64,19,19,4131,18,60,42,18,0,2,2,-0.388888889,10,40
64,20,20,3447,5,50,45,5,0,-15,15,4,10,60
64,21,21,3684,5,70,65,5,0,5,5,-2,10,60
64,22,22,3558,25,60,35,25,0,-5,5,0.76,30,40
64,23,23,3899,-4,50,54,4,0,14,14,-0.25,-10,40
64,24,24,3890,5,60,55,5,0,-5,5,2,10,60
64,25,25,3219,-25,30,55,25,0,15,15,0.8,-30,40
64,26,26,3012,5,40,35,5,0,-5,5,2,10,40
64,27,27,3353,15,80,65,15,0,5,5,-0.933333333,10,60
64,28,28,3621,-11,40,51,11,0,-9,9,,-10,60
64,29,29,3040,-25,20,45,25,0,5,5,,-30,40
64,30,0,3688,-35,40,75,35,1,35,35,1.142857143,-30,40
64,31,1,2937,55,100,45,55,1,-15,15,-0.181818182,50,60
64,32,2,3033,-15,20,35,15,1,-5,5,-2,-10,40
64,33,3,2981,5,40,35,5,1,-25,25,0,10,60
64,34,4,2968,-5,60,65,5,1,25,25,0,-10,40
64,35,5,2972,15,80,65,15,1,25,25,0.666666667,10,40
64,36,6,2932,45,80,35,45,1,-25,25,0.666666667,50,60
64,37,7,2886,-45,20,65,45,1,5,5,0.444444444,-50,60
64,38,8,3055,-75,0,75,75,1,35,35,0.133333333,-70,40
64,39,9,2804,15,60,45,15,1,-15,15,0.666666667,10,60
64,40,10,2822,45,100,55,45,1,-5,5,-0.222222222,50,60
64,41,11,2864,-45,20,65,45,1,25,25,0.666666667,-50,40
64,42,12,3203,25,60,35,25,1,-5,5,0,30,40
64,43,13,2876,35,80,45,35,1,-15,15,-0.285714286,30,60
64,44,14,2826,5,40,35,5,1,-5,5,3,10,40
64,45,15,2971,25,60,35,25,1,-25,25,0.8,30,60
64,46,16,4281,30,80,50,30,1,10,10,-0.5,30,40
64,47,17,3019,-15,40,55,15,1,-5,5,-0.666666667,-10,60
64,48,18,3320,-45,20,65,45,1,5,5,0.888888889,-50,60
64,49,19,3196,-35,0,35,35,1,-5,5,-0.285714286,-30,40
64,50,20,2943,-25,20,45,25,1,5,5,0,-30,40
64,51,21,3462,55,80,25,55,1,-35,35,0,50,60
64,52,22,2905,-5,20,25,5,1,-35,35,-5,-10,60
64,53,23,2986,15,60,45,15,1,5,5,1.333333333,10,40
64,54,24,3778,10,60,50,10,1,-10,10,-1.5,10,60
64,55,25,2968,15,80,65,15,1,25,25,0,10,40
64,56,26,4712,65,100,35,65,1,-25,25,-0.076923077,70,60
64,57,27,2828,-25,40,65,25,1,25,25,1.2,-30,40
64,58,28,3855,-35,0,35,35,1,-5,5,,-30,40
64,59,29,3786,10,40,30,10,1,-30,30,,10,60
65,0,0,4792,-10,60,70,10,1,30,30,3,-10,40
65,1,1,3301,30,80,50,30,1,-10,10,0.333333333,30,60
65,2,2,3242,0,40,40,0,1,0,0,,,40
65,3,3,3262,-20,40,60,20,1,0,0,-1,-10,60
65,4,4,3219,-30,20,50,30,1,10,10,0.333333333,-30,40
65,5,5,3584,-40,0,40,40,1,0,0,0,-50,40
65,6,6,3187,-20,60,80,20,1,20,20,1,-10,60
65,7,7,3499,-40,20,60,40,1,0,0,0.25,-50,60
65,8,8,3793,40,80,40,40,1,0,0,0.5,50,40
65,9,9,4145,50,100,50,50,1,-10,10,0.4,50,60
65,10,10,3058,-30,40,70,30,1,10,10,1,-30,60
65,11,11,3409,20,80,60,20,1,20,20,0.5,10,40
65,12,12,3907,-10,60,70,10,1,30,30,0,-10,40
65,13,13,3195,20,60,40,20,1,-20,20,2,10,60
65,14,14,3200,-70,0,70,70,1,30,30,0.714285714,-70,40
65,15,15,4093,20,100,80,20,1,20,20,-4,10,60
65,16,16,4673,0,20,20,0,1,-20,20,,,40
65,17,17,3206,80,80,0,80,1,-60,60,1.25,70,60
65,18,18,4093,-80,20,100,80,1,40,40,0.75,-70,60
65,19,19,3059,-30,40,70,30,1,30,30,1,-30,40
65,20,20,3579,0,40,40,0,1,0,0,,,40
65,21,21,3643,40,80,40,40,1,-20,20,1.5,50,60
65,22,22,3745,-80,20,100,80,1,40,40,0,-70,60
65,23,23,3869,60,80,20,60,1,-20,20,1,50,40
65,24,24,3603,-60,40,100,60,1,40,40,0.666666667,-50,60
65,25,25,3643,-60,20,80,60,1,40,40,1,-50,40
65,26,26,3164,0,60,60,0,1,0,0,,,60
65,27,27,3294,-20,0,20,20,1,-20,20,-1,-10,40
65,28,28,4812,20,60,40,20,1,0,0,,10,40
65,29,29,3998,20,100,80,20,1,20,20,,10,60
65,30,0,3417,-30,50,80,30,0,20,20,0,-30,60
65,31,1,3380,-40,40,80,40,0,40,40,0.25,-50,40
65,32,2,4836,-20,50,70,20,0,30,30,2.5,-10,40
65,33,3,3369,-40,40,80,40,0,20,20,-0.5,-50,60
65,34,4,4043,-30,70,100,30,0,40,40,1.666666667,-30,60
65,35,5,3236,10,30,20,10,0,-20,20,3,10,40
65,36,6,3284,-30,20,50,30,0,10,10,0.333333333,-30,40
65,37,7,4288,30,80,50,30,0,-10,10,-0.333333333,30,60
65,38,8,4764,20,60,40,20,0,0,0,2,10,40
65,39,9,4315,20,60,40,20,0,-20,20,1.5,10,60
65,40,10,4403,-50,30,80,50,0,40,40,0.8,-50,40
65,41,11,4063,-10,60,70,10,0,10,10,5,-10,60
65,42,12,4810,60,80,20,60,0,-40,40,0.666666667,50,60
65,43,13,3802,20,60,40,20,0,0,0,1,10,40
65,44,14,5541,-20,40,60,20,0,0,0,-1,-10,60
65,45,15,4523,-10,50,60,10,0,20,20,2,-10,40
65,46,16,3385,-10,70,80,10,0,20,20,1,-10,60
65,47,17,3690,-20,20,40,20,0,0,0,-1,-10,40
65,48,18,6210,-20,50,70,20,0,10,10,0,-10,60
65,49,19,4080,-20,40,60,20,0,20,20,0,-10,40
65,50,20,3850,-30,40,70,30,0,10,10,0.666666667,-30,60
65,51,21,5007,10,60,50,10,0,-10,10,3,10,60
65,52,22,4034,-30,30,60,30,0,20,20,0.666666667,-30,40
65,53,23,3255,10,50,40,10,0,0,0,1,10,40
65,54,24,3642,0,80,80,0,0,20,20,,,60
65,55,25,3690,-10,40,50,10,0,10,10,1,-10,40
65,56,26,3569,20,60,40,20,0,0,0,1,10,40
65,57,27,3679,0,70,70,0,0,10,10,,,60
65,58,28,3682,0,50,50,0,0,-10,10,,,60
65,59,29,3782,-40,20,60,40,0,20,20,,-50,40
66,0,0,2935,-40,40,80,40,0,20,20,0.25,-50,60
66,1,1,4190,-30,20,50,30,0,10,10,0,-30,40
66,2,2,4019,-20,30,50,20,0,10,10,0.5,-10,40
66,3,3,2855,10,80,70,10,0,10,10,-1,10,60
66,4,4,4862,0,60,60,0,0,0,0,,,60
66,5,5,5911,0,40,40,0,0,0,0,,,40
66,6,6,3570,20,60,40,20,0,0,0,-0.5,10,40
66,7,7,4763,0,70,70,0,0,10,10,,,60
66,8,8,5998,20,50,30,20,0,-10,10,1,10,40
66,9,9,3724,-30,50,80,30,0,20,20,0.666666667,-30,60
66,10,10,3248,-30,20,50,30,0,10,10,,-30,40
66,11,11,5760,-10,50,60,10,0,0,0,-1,-10,60
66,12,12,5448,-10,60,70,10,0,10,10,-1,-10,60
66,13,13,7006,,30,,,0,,,,,40
66,14,14,4019,0,80,80,0,0,20,20,,,60
66,15,15,2775,10,50,40,10,0,0,0,0,10,40
66,16,16,2746,0,70,70,0,0,10,10,,,60
66,17,17,3017,20,60,40,20,0,0,0,1.5,10,40
66,18,18,2679,-30,40,70,30,0,10,10,-0.333333333,-30,60
66,19,19,3146,-30,40,70,30,0,30,30,0.666666667,-30,40
66,20,20,3327,-30,50,80,30,0,20,20,0,-30,60
66,21,21,3340,-40,40,80,40,0,20,20,0,-50,60
66,22,22,3606,-30,20,50,30,0,10,10,-1,-30,40
66,23,23,5364,-50,30,80,50,0,40,40,0.8,-50,40
66,24,24,4569,-20,60,80,20,0,20,20,0.5,-10,60
66,25,25,3040,20,60,40,20,0,0,0,0,10,40
66,26,26,3450,10,50,40,10,0,0,0,0,10,40
66,27,27,2685,10,80,70,10,0,10,10,0,10,60
66,28,28,4450,0,70,70,0,0,10,10,,,60
66,29,29,3055,0,40,40,0,0,0,0,,,40
66,30,0,5915,0,80,80,0,1,40,40,,,40
66,31,1,4455,60,100,40,60,1,-20,20,0.666666667,50,60
66,32,2,3814,-40,20,60,40,1,20,20,0.75,-50,40
66,33,3,3823,0,80,80,0,1,20,20,,,60
66,34,4,5012,-30,0,30,30,1,-10,10,0,-30,40
66,35,5,2763,30,60,30,30,1,-10,10,0,30,40
66,36,6,4487,-20,60,80,20,1,20,20,2.5,-10,60
66,37,7,3278,-10,20,30,10,1,-30,30,-4,-10,60
66,38,8,4232,10,40,30,10,1,-10,10,0,10,40
66,39,9,3072,-30,40,70,30,1,10,10,0,-30,60
66,40,10,3176,-50,20,70,50,1,10,10,-0.2,-50,60
66,41,11,6163,50,80,30,50,1,-10,10,0.2,50,40
66,42,12,2723,-40,0,40,40,1,0,0,0,-50,40
66,43,13,3732,0,80,80,0,1,20,20,,,60
66,44,14,4250,0,40,40,0,1,0,0,,,40
66,45,15,3446,-20,60,80,20,1,20,20,0.5,-10,60
66,46,16,4337,30,60,30,30,1,-10,10,0.333333333,30,40
66,47,17,3917,-30,40,70,30,1,10,10,1,-30,60
66,48,18,3583,60,100,40,60,1,-20,20,0.666666667,50,60
66,49,19,2616,-20,20,40,20,1,0,0,0.5,-10,40
66,50,20,4334,10,40,30,10,1,-10,10,2,10,40
66,51,21,3831,0,80,80,0,1,20,20,,,60
66,52,22,4012,-50,20,70,50,1,10,10,0,-50,60
66,53,23,3845,30,80,50,30,1,10,10,0.666666667,30,40
66,54,24,3285,-10,60,70,10,1,10,10,-1,-10,60
66,55,25,3551,-50,20,70,50,1,30,30,0.6,-50,40
66,56,26,3660,-40,40,80,40,1,20,20,0.25,-50,60
66,57,27,2570,20,60,40,20,1,0,0,0,10,40
66,58,28,2853,-40,0,40,40,1,0,0,,-50,40
66,59,29,3143,30,100,70,30,1,10,10,,30,60
67,0,0,3297,20,70,50,20,0,-10,10,1.5,10,60
67,1,1,4273,20,50,30,20,0,-10,10,0,10,40
67,2,2,2715,30,60,30,30,0,-10,10,0,30,40
67,3,3,2851,-20,60,80,20,0,20,20,0.5,-10,60
67,4,4,4819,-20,50,70,20,0,10,10,-1,-10,60
67,5,5,2763,0,30,30,0,0,-10,10,,,40
67,6,6,2690,-20,20,40,20,0,0,0,0.5,-10,40
67,7,7,2658,-10,80,90,10,0,30,30,2,-10,60
67,8,8,2923,10,40,30,10,0,-10,10,1,10,40
67,9,9,2803,-30,40,70,30,0,10,10,-0.333333333,-30,60
67,10,10,4291,20,60,40,20,0,0,0,-0.5,10,40
67,11,11,2755,-30,50,80,30,0,20,20,0,-30,60
67,12,12,2722,-40,40,80,40,0,20,20,0,-50,60
67,13,13,3290,-10,20,30,10,0,-10,10,-1,-10,40
67,14,14,2802,-10,70,80,10,0,20,20,1,-10,60
67,15,15,2675,-10,30,40,10,0,0,0,0,-10,40
67,16,16,2771,10,80,70,10,0,10,10,1,10,60
67,17,17,3578,0,40,40,0,0,0,0,,,40
67,18,18,2931,-20,60,80,20,0,20,20,0,-10,60
67,19,19,2811,10,50,40,10,0,0,0,0,10,40
67,20,20,2721,0,80,80,0,0,20,20,,,60
67,21,21,3626,-10,70,80,10,0,20,20,1,-10,60
67,22,22,2810,-10,30,40,10,0,0,0,0,-10,40
67,23,23,2811,20,60,40,20,0,0,0,0,10,40
67,24,24,2739,-20,50,70,20,0,10,10,-0.5,-10,60
67,25,25,2778,-20,20,40,20,0,0,0,0,-10,40
67,26,26,5067,0,40,40,0,0,0,0,,,40
67,27,27,2898,-40,40,80,40,0,20,20,0,-50,60
67,28,28,3115,-20,60,80,20,0,20,20,,-10,60
67,29,29,3075,10,50,40,10,0,0,0,,10,40
67,30,0,3043,10,60,50,10,1,10,10,-1,10,40
67,31,1,2738,30,80,50,30,1,-10,10,1,30,60
67,32,2,2873,-40,0,40,40,1,0,0,0.5,-50,40
67,33,3,2802,-40,40,80,40,1,20,20,0.5,-50,60
67,34,4,2979,20,40,20,20,1,-20,20,0.5,10,40
67,35,5,3163,-10,20,30,10,1,-10,10,0,-10,40
67,36,6,2699,0,60,60,0,1,0,0,,,60
67,37,7,3963,40,100,60,40,1,0,0,0.25,50,60
67,38,8,2787,50,80,30,50,1,-10,10,0,50,40
67,39,9,2810,-50,20,70,50,1,10,10,0,-50,60
67,40,10,3674,10,80,70,10,1,10,10,0,10,60
67,41,11,2707,-10,20,30,10,1,-10,10,0,-10,40
67,42,12,2795,-30,0,30,30,1,-10,10,0.333333333,-30,40
67,43,13,2891,-30,40,70,30,1,10,10,0,-30,60
67,44,14,2747,60,80,20,60,1,-20,20,0.166666667,50,40
67,45,15,2779,-10,60,70,10,1,10,10,0,-10,60
67,46,16,4785,30,60,30,30,1,-10,10,0,30,40
67,47,17,2748,-50,20,70,50,1,10,10,0,-50,60
67,48,18,2882,30,100,70,30,1,10,10,0.333333333,30,60
67,49,19,3179,10,40,30,10,1,-10,10,0,10,40
67,50,20,5203,-30,0,30,30,1,-10,10,0,-30,40
67,51,21,2882,-20,60,80,20,1,20,20,0,-10,60
67,52,22,3315,20,100,80,20,1,20,20,0,10,60
67,53,23,2969,-10,20,30,10,1,-10,10,0,-10,40
67,54,24,2964,-40,40,80,40,1,20,20,0,-50,60
67,55,25,3338,50,80,30,50,1,-10,10,0,50,40
67,56,26,2930,-60,20,80,60,1,20,20,0,-50,60
67,57,27,2771,10,40,30,10,1,-10,10,0,10,40
67,58,28,2706,30,60,30,30,1,-10,10,,30,40
67,59,29,2995,0,80,80,0,1,20,20,,,60
68,0,0,4668,-10,70,80,10,0,20,20,0,-10,60
68,1,1,4937,20,60,40,20,0,0,0,1,10,40
68,2,2,5407,-20,40,60,20,0,20,20,0.5,-10,40
68,3,3,4951,-30,50,80,30,0,20,20,0,-30,60
68,4,4,6082,0,80,80,0,0,20,20,,,60
68,5,5,4953,0,50,50,0,0,10,10,,,40
68,6,6,5665,-60,20,80,60,0,40,40,0.5,-50,40
68,7,7,5740,-40,40,80,40,0,20,20,0,-50,60
68,8,8,4596,-20,30,50,20,0,10,10,0.5,-10,40
68,9,9,4935,-20,60,80,20,0,20,20,0.5,-10,60
68,10,10,4429,-20,20,40,20,0,0,0,0,-10,40
68,11,11,5209,0,70,70,0,0,10,10,,,60
68,12,12,4804,-20,50,70,20,0,10,10,0,-10,60
68,13,13,5103,0,40,40,0,0,0,0,,,40
68,14,14,5419,-30,40,70,30,0,10,10,-0.333333333,-30,60
68,15,15,3972,-10,30,40,10,0,0,0,0,-10,40
68,16,16,5171,-20,60,80,20,0,20,20,0.5,-10,60
68,17,17,3419,20,60,40,20,0,0,0,0,10,40
68,18,18,3063,10,80,70,10,0,10,10,0,10,60
68,19,19,3286,10,50,40,10,0,0,0,0,10,40
68,20,20,2874,-10,60,70,10,0,10,10,0,-10,60
68,21,21,3149,10,80,70,10,0,10,10,0,10,60
68,22,22,4916,20,60,40,20,0,0,0,0,10,40
68,23,23,3242,-20,20,40,20,0,0,0,0,-10,40
68,24,24,4016,-30,40,70,30,0,10,10,0,-30,60
68,25,25,2834,0,40,40,0,0,0,0,,,40
68,26,26,2872,-10,30,40,10,0,0,0,0,-10,40
68,27,27,3139,0,70,70,0,0,10,10,,,60
68,28,28,3161,-20,50,70,20,0,10,10,,-10,60
68,29,29,2871,10,50,40,10,0,0,0,,10,40
68,30,0,2896,-60,20,80,60,1,40,40,1,-50,40
68,31,1,2778,20,100,80,20,1,20,20,1,10,60
68,32,2,2779,20,40,20,20,1,-20,20,0.5,10,40
68,33,3,3013,-80,20,100,80,1,40,40,0.375,-70,60
68,34,4,4122,50,80,30,50,1,-10,10,0,50,40
68,35,5,4995,-30,0,30,30,1,-10,10,-0.333333333,-30,40
68,36,6,4101,-10,60,70,10,1,10,10,0,-10,60
68,37,7,3582,-30,40,70,30,1,10,10,0,-30,60
68,38,8,2794,20,60,40,20,1,0,0,0,10,40
68,39,9,5545,10,80,70,10,1,10,10,0,10,60
68,40,10,4126,10,80,70,10,1,10,10,0,10,60
68,41,11,5371,0,40,40,0,1,0,0,,,40
68,42,12,3009,40,80,40,40,1,0,0,0,50,40
68,43,13,2967,30,100,70,30,1,10,10,0,30,60
68,44,14,3585,20,60,40,20,1,0,0,0,10,40
68,45,15,4052,-10,60,70,10,1,10,10,0,-10,60
68,46,16,4222,-40,0,40,40,1,0,0,0,-50,40
68,47,17,3108,-30,40,70,30,1,10,10,0,-30,60
68,48,18,2786,-50,20,70,50,1,10,10,0,-50,60
68,49,19,3611,-20,20,40,20,1,0,0,0,-10,40
68,50,20,2837,-40,0,40,40,1,0,0,-0.75,-50,40
68,51,21,3145,30,100,70,30,1,10,10,0,30,60
68,52,22,4634,-50,20,70,50,1,10,10,0,-50,60
68,53,23,3853,-50,20,70,50,1,30,30,0.6,-50,40
68,54,24,2819,10,80,70,10,1,10,10,0,10,60
68,55,25,2671,0,40,40,0,1,0,0,,,40
68,56,26,3024,-10,60,70,10,1,10,10,0,-10,60
68,57,27,2726,40,80,40,40,1,0,0,0,50,40
68,58,28,3337,20,60,40,20,1,0,0,,10,40
68,59,29,4083,-30,40,70,30,1,10,10,,-30,60
69,0,0,4645,-60,0,60,60,1,20,20,0.5,-50,40
69,1,1,4511,80,100,20,80,1,-40,40,0,70,60
69,2,2,3979,30,60,30,30,1,-10,10,-0.333333333,30,40
69,3,3,4498,40,60,20,40,1,-40,40,1.5,50,60
69,4,4,4763,60,80,20,60,1,-20,20,1.166666667,50,40
69,5,5,3988,-50,40,90,50,1,50,50,1.2,-50,40
69,6,6,4250,-60,20,80,60,1,20,20,0.333333333,-50,60
69,7,7,4915,20,80,60,20,1,0,0,1,10,60
69,8,8,4674,-10,20,30,10,1,-10,10,0,-10,40
69,9,9,4689,-40,40,80,40,1,20,20,1.75,-50,60
69,10,10,4441,70,80,10,70,1,-50,50,0.142857143,70,60
69,11,11,5267,10,40,30,10,1,-10,10,1,10,40
69,12,12,5419,20,60,40,20,1,0,0,1.5,10,40
69,13,13,4089,40,60,20,40,1,-40,40,1.5,50,60
69,14,14,5133,-50,20,70,50,1,30,30,1,-50,40
69,15,15,4040,-40,40,80,40,1,20,20,1,-50,60
69,16,16,4040,-20,0,20,20,1,-20,20,-1,-10,40
69,17,17,4555,60,100,40,60,1,-20,20,0.666666667,50,60
69,18,18,4380,-60,20,80,60,1,20,20,0.333333333,-50,60
69,19,19,5422,40,80,40,40,1,0,0,-0.5,50,40
69,20,20,4935,20,40,20,20,1,-20,20,0,10,40
69,21,21,4752,20,80,60,20,1,0,0,-2,10,60
69,22,22,4091,80,100,20,80,1,-40,40,0.125,70,60
69,23,23,5626,-20,0,20,20,1,-20,20,0,-10,40
69,24,24,5473,30,60,30,30,1,-30,30,1.333333333,30,60
69,25,25,4168,60,80,20,60,1,-20,20,0.333333333,50,40
69,26,26,4855,-30,40,70,30,1,10,10,0.333333333,-30,60
69,27,27,4348,-20,20,40,20,1,0,0,1,-10,40
69,28,28,4376,40,60,20,40,1,-20,20,,50,40
69,29,29,5162,-40,20,60,40,1,0,0,,-50,60
69,30,0,4571,-50,40,90,50,0,30,30,1.2,-50,60
69,31,1,4389,0,50,50,0,0,10,10,,,40
69,32,2,4509,-40,30,70,40,0,30,30,1,-50,40
69,33,3,4564,20,50,30,20,0,-30,30,0.5,10,60
69,34,4,5032,30,70,40,30,0,-20,20,1.666666667,30,60
69,35,5,4352,-10,20,30,10,0,-10,10,0,-10,40
69,36,6,4650,10,40,30,10,0,-10,10,0,10,40
69,37,7,4139,-30,60,90,30,0,30,30,-0.333333333,-30,60
69,38,8,4821,30,60,30,30,0,-10,10,-1,30,40
69,39,9,4342,-20,80,100,20,0,40,40,2,-10,60
69,40,10,4698,20,20,0,20,0,-40,40,1,10,40
69,41,11,4655,-10,50,60,10,0,0,0,-1,-10,60
69,42,12,4228,-30,40,70,30,0,10,10,-0.666666667,-30,60
69,43,13,4394,30,50,20,30,0,-20,20,0.333333333,30,40
69,44,14,3986,-30,60,90,30,0,30,30,0,-30,60
69,45,15,4186,30,60,30,30,0,-10,10,-0.333333333,30,40
69,46,16,4542,-20,70,90,20,0,30,30,0.5,-10,60
69,47,17,4097,10,30,20,10,0,-20,20,1,10,40
69,48,18,4752,0,80,80,0,0,20,20,,,60
69,49,19,4271,10,40,30,10,0,-10,10,-2,10,40
69,50,20,4471,20,80,60,20,0,0,0,-0.5,10,60
69,51,21,4235,-10,40,50,10,0,-10,10,-1,-10,60
69,52,22,4106,50,60,10,50,0,-30,30,0.2,50,40
69,53,23,4603,0,20,20,0,0,-20,20,,,40
69,54,24,4227,-10,50,60,10,0,0,0,-1,-10,60
69,55,25,4022,10,30,20,10,0,-20,20,2,10,40
69,56,26,4659,0,40,40,0,0,0,0,,,40
69,57,27,4494,0,70,70,0,0,10,10,,,60
69,58,28,4864,-30,60,90,30,0,30,30,,-30,60
69,59,29,4284,10,50,40,10,0,0,0,,10,40
70,0,0,3358,-10,80,90,10,0,30,30,0,-10,60
70,1,1,3514,30,60,30,30,0,-10,10,0.666666667,30,40
70,2,2,3019,0,50,50,0,0,10,10,,,40
70,3,3,3197,-40,50,90,40,0,30,30,0.5,-50,60
70,4,4,3484,0,70,70,0,0,10,10,,,60
70,5,5,3376,10,40,30,10,0,-10,10,2,10,40
70,6,6,3190,-20,30,50,20,0,10,10,1,-10,40
70,7,7,2865,-40,40,80,40,0,20,20,0.5,-50,60
70,8,8,3157,-10,20,30,10,0,-10,10,-1,-10,40
70,9,9,3600,0,60,60,0,0,0,0,,,60
70,10,10,3002,20,60,40,20,0,0,0,0,10,40
70,11,11,3231,-10,60,70,10,0,10,10,1,-10,60
70,12,12,4106,10,70,60,10,0,0,0,1,10,60
70,13,13,3263,10,50,40,10,0,0,0,0,10,40
70,14,14,3468,-30,40,70,30,0,10,10,0.333333333,-30,60
70,15,15,3102,0,40,40,0,0,0,0,,,40
70,16,16,3026,-10,50,60,10,0,0,0,0,-10,60
70,17,17,3024,-20,20,40,20,0,0,0,-0.5,-10,40
70,18,18,3046,20,80,60,20,0,0,0,0.5,10,60
70,19,19,3490,-20,30,50,20,0,10,10,1,-10,40
70,20,20,2958,-30,40,70,30,0,10,10,0.333333333,-30,60
70,21,21,2817,-10,50,60,10,0,0,0,0,-10,60
70,22,22,3230,30,60,30,30,0,-10,10,0.666666667,30,40
70,23,23,3109,0,50,50,0,0,10,10,,,40
70,24,24,3118,20,80,60,20,0,0,0,0.5,10,60
70,25,25,3021,-20,20,40,20,0,0,0,0.5,-10,40
70,26,26,3079,0,30,30,0,0,-10,10,,,40
70,27,27,3009,-10,60,70,10,0,10,10,0,-10,60
70,28,28,3358,0,70,70,0,0,10,10,,,60
70,29,29,2898,-10,40,50,10,0,10,10,,-10,40
70,30,0,3446,-50,20,70,50,1,30,30,1,-50,40
70,31,1,3037,40,100,60,40,1,0,0,0.5,50,60
70,32,2,3230,60,80,20,60,1,-20,20,0.5,50,40
70,33,3,2989,-60,20,80,60,1,20,20,0.5,-50,60
70,34,4,3250,10,60,50,10,1,10,10,0,10,40
70,35,5,3756,-10,40,50,10,1,10,10,1,-10,40
70,36,6,3092,-10,40,50,10,1,-10,10,-1,-10,60
70,37,7,3368,20,80,60,20,1,0,0,0.5,10,60
70,38,8,3040,-40,0,40,40,1,0,0,0.5,-50,40
70,39,9,2884,-10,60,70,10,1,10,10,2,-10,60
70,40,10,4207,30,80,50,30,1,-10,10,1,30,60
70,41,11,3143,60,80,20,60,1,-20,20,0.5,50,40
70,42,12,3038,-50,0,50,50,1,10,10,0.2,-50,40
70,43,13,3367,-20,60,80,20,1,20,20,0.5,-10,60
70,44,14,2932,-20,20,40,20,1,0,0,0.5,-10,40
70,45,15,3384,-50,20,70,50,1,10,10,0.2,-50,60
70,46,16,3524,10,40,30,10,1,-10,10,0,10,40
70,47,17,2922,-20,40,60,20,1,0,0,1,-10,60
70,48,18,3424,60,100,40,60,1,-20,20,0.5,50,60
70,49,19,2945,30,60,30,30,1,-10,10,0.666666667,30,40
70,50,20,3438,10,60,50,10,1,10,10,1,10,40
70,51,21,2920,-10,60,70,10,1,10,10,3,-10,60
70,52,22,4219,-20,20,40,20,1,-20,20,-1.5,-10,60
70,53,23,3579,20,80,60,20,1,20,20,-2,10,40
70,54,24,3004,30,100,70,30,1,10,10,-1,30,60
70,55,25,2864,20,40,20,20,1,-20,20,1.5,10,40
70,56,26,3524,0,40,40,0,1,-20,20,,,60
70,57,27,2922,-30,20,50,30,1,10,10,-1.666666667,-30,40
70,58,28,3247,-100,0,100,100,1,60,60,,-70,40
70,59,29,3385,-20,80,100,20,1,40,40,,-10,60
71,0,0,3979,10,60,50,10,0,-10,10,3,10,60
71,1,1,4241,5,40,35,5,0,-5,5,1,10,40
71,2,2,3271,-20,20,40,20,0,0,0,-0.25,-10,40
71,3,3,3644,-30,50,80,30,0,20,20,0.5,-30,60
71,4,4,3120,5,70,65,5,0,5,5,1,10,60
71,5,5,3744,5,50,45,5,0,5,5,5,10,40
71,6,6,3355,-40,30,70,40,0,30,30,0.75,-50,40
71,7,7,3227,10,80,70,10,0,10,10,0,10,60
71,8,8,3192,20,60,40,20,0,0,0,0.5,10,40
71,9,9,3302,-30,40,70,30,0,10,10,0,-30,60
71,10,10,3220,-30,20,50,30,0,10,10,0.333333333,-30,40
71,11,11,3136,-30,40,70,30,0,10,10,0.333333333,-30,60
71,12,12,3463,0,60,60,0,0,0,0,,,60
71,13,13,3545,0,40,40,0,0,0,0,,,40
71,14,14,3253,-30,50,80,30,0,20,20,-0.333333333,-30,60
71,15,15,3144,20,60,40,20,0,0,0,0,10,40
71,16,16,3104,-20,70,90,20,0,30,30,0.5,-10,60
71,17,17,3132,-10,30,40,10,0,0,0,0,-10,40
71,18,18,3037,0,80,80,0,0,20,20,,,60
71,19,19,2980,10,50,40,10,0,0,0,0,10,40
71,20,20,3487,-20,60,80,20,0,20,20,0.5,-10,60
71,21,21,3515,0,70,70,0,0,10,10,,,60
71,22,22,3161,-10,30,40,10,0,0,0,1,-10,40
71,23,23,3534,30,60,30,30,0,-10,10,0,30,40
71,24,24,2928,-30,40,70,30,0,10,10,0.666666667,-30,60
71,25,25,2926,10,40,30,10,0,-10,10,1,10,40
71,26,26,3038,10,50,40,10,0,0,0,-1,10,40
71,27,27,3476,30,80,50,30,0,-10,10,0.666666667,30,60
71,28,28,3182,-20,50,70,20,0,10,10,,-10,60
71,29,29,3010,-10,20,30,10,0,-10,10,,-10,40
71,30,0,3920,30,80,50,30,1,10,10,0.666666667,30,40
71,31,1,3913,-20,20,40,20,1,-20,20,-0.5,-10,60
71,32,2,3055,-50,20,70,50,1,30,30,0.6,-50,40
71,33,3,3047,-10,40,50,10,1,-10,10,-1,-10,60
71,34,4,3152,20,60,40,20,1,0,0,0.5,10,40
71,35,5,3498,-10,40,50,10,1,10,10,2,-10,40
71,36,6,3304,40,100,60,40,1,0,0,-0.5,50,60
71,37,7,3454,20,60,40,20,1,-20,20,0.5,10,60
71,38,8,2964,-30,0,30,30,1,-10,10,0,-30,40
71,39,9,3197,30,80,50,30,1,-10,10,1.333333333,30,60
71,40,10,3220,-10,80,90,10,1,30,30,4,-10,60
71,41,11,3122,50,80,30,50,1,-10,10,0.2,50,40
71,42,12,3082,20,60,40,20,1,0,0,1.5,10,40
71,43,13,3177,-10,40,50,10,1,-10,10,-3,-10,60
71,44,14,2890,-50,20,70,50,1,30,30,1,-50,40
71,45,15,3106,-20,60,80,20,1,20,20,2,-10,60
71,46,16,3096,20,40,20,20,1,-20,20,1,10,40
71,47,17,3122,60,100,40,60,1,-20,20,0.333333333,50,60
71,48,18,3492,-40,20,60,40,1,0,0,0.25,-50,60
71,49,19,3135,-40,0,40,40,1,0,0,0.5,-50,40
71,50,20,3109,40,60,20,40,1,-20,20,0,50,40
71,51,21,2973,-30,20,50,30,1,-10,10,0.333333333,-30,60
71,52,22,2924,60,100,40,60,1,-20,20,0.333333333,50,60
71,53,23,2965,60,80,20,60,1,-20,20,0.5,50,40
71,54,24,3200,-20,40,60,20,1,0,0,1,-10,60
71,55,25,3249,-50,0,50,50,1,10,10,0.4,-50,40
71,56,26,3128,40,80,40,40,1,-20,20,0.75,50,60
71,57,27,3044,10,40,30,10,1,-10,10,-2,10,40
71,58,28,3666,10,20,10,10,1,-30,30,,10,40
71,59,29,3571,-10,60,70,10,1,10,10,,-10,60
72,0,0,5104,-10,60,70,10,1,30,30,0,-10,40
72,1,1,3143,-20,20,40,20,1,-20,20,1,-10,60
72,2,2,3283,-30,40,70,30,1,30,30,1,-30,40
72,3,3,3631,60,80,20,60,1,-40,40,0,50,60
72,4,4,3226,40,80,40,40,1,0,0,0,50,40
72,5,5,3512,-20,20,40,20,1,0,0,-2,-10,40
72,6,6,3450,40,60,20,40,1,-40,40,0,50,60
72,7,7,3254,20,40,20,20,1,-40,40,3,10,60
72,8,8,4231,-80,0,80,80,1,40,40,0.25,-70,40
72,9,9,3259,20,100,80,20,1,20,20,-3,10,60
72,10,10,4255,40,60,20,40,1,-40,40,0.5,50,60
72,11,11,3519,-40,20,60,40,1,20,20,1.25,-50,40
72,12,12,3137,30,40,10,30,1,-30,30,1,30,40
72,13,13,3185,60,100,40,60,1,-20,20,0.333333333,50,60
72,14,14,3044,-40,0,40,40,1,0,0,0,-50,40
72,15,15,3733,-20,40,60,20,1,0,0,0,-10,60
72,16,16,4114,40,80,40,40,1,0,0,0,50,40
72,17,17,3108,-40,20,60,40,1,0,0,-0.5,-50,60
72,18,18,3920,0,80,80,0,1,20,20,,,60
72,19,19,4089,20,60,40,20,1,0,0,-1,10,40
72,20,20,3084,40,60,20,40,1,-20,20,-0.5,50,40
72,21,21,3107,40,100,60,40,1,0,0,-0.5,50,60
72,22,22,3153,-20,20,40,20,1,-20,20,-1,-10,60
72,23,23,3311,40,40,0,40,1,-40,40,1,50,40
72,24,24,3201,20,80,60,20,1,0,0,-1,10,60
72,25,25,5405,-40,0,40,40,1,0,0,0.5,-50,40
72,26,26,3224,20,60,40,20,1,-20,20,1,10,60
72,27,27,3241,0,20,20,0,1,-20,20,,,40
72,28,28,3669,40,80,40,40,1,0,0,,50,40
72,29,29,3523,-20,40,60,20,1,0,0,,-10,60
72,30,0,5051,0,80,80,0,0,20,20,,,60
72,31,1,3491,-60,40,100,60,0,60,60,1.333333333,-50,40
72,32,2,3029,0,20,20,0,0,-20,20,,,40
72,33,3,4338,20,60,40,20,0,-20,20,1,10,60
72,34,4,3099,-20,40,60,20,0,0,0,1,-10,60
72,35,5,3521,0,60,60,0,0,20,20,,,40
72,36,6,3158,-10,50,60,10,0,20,20,0,-10,40
72,37,7,3894,10,50,40,10,0,-20,20,2,10,60
72,38,8,3187,-30,30,60,30,0,20,20,0.666666667,-30,40
72,39,9,4453,10,70,60,10,0,0,0,0,10,60
72,40,10,3425,-20,20,40,20,0,0,0,1,-10,40
72,41,11,3459,-20,40,60,20,0,0,0,1,-10,60
72,42,12,3567,10,50,40,10,0,-20,20,1,10,60
72,43,13,3748,10,30,20,10,0,-20,20,0,10,40
72,44,14,5325,10,60,50,10,0,-10,10,-2,10,60
72,45,15,3687,20,40,20,20,0,-20,20,1.5,10,40
72,46,16,7730,40,70,30,40,0,-30,30,1,50,60
72,47,17,3824,10,60,50,10,0,10,10,0,10,40
72,48,18,4013,10,80,70,10,0,10,10,-4,10,60
72,49,19,4021,0,50,50,0,0,10,10,,,40
72,50,20,4245,10,40,30,10,0,-30,30,4,10,60
72,51,21,4265,-10,60,70,10,0,10,10,0,-10,60
72,52,22,3755,-10,20,30,10,0,-10,10,-2,-10,40
72,53,23,4160,-20,30,50,20,0,10,10,1.5,-10,40
72,54,24,5684,10,80,70,10,0,10,10,0,10,60
72,55,25,5197,20,40,20,20,0,-20,20,0.5,10,40
72,56,26,3826,20,50,30,20,0,-10,10,0,10,40
72,57,27,5016,0,70,70,0,0,10,10,,,60
72,58,28,4970,-10,50,60,10,0,0,0,,-10,60
72,59,29,5081,30,60,30,30,0,-10,10,,30,40
73,0,0,5286,-67,0,67,67,1,27,27,0.701492537,-70,40
73,1,1,5183,16,100,84,16,1,24,24,-3.875,10,60
73,2,2,5843,60,80,20,60,1,-20,20,0.083333333,50,40
73,3,3,4129,58,80,22,58,1,-38,38,0.913793103,50,60
73,4,4,4491,15,40,25,15,1,-15,15,1.933333333,10,40
73,5,5,5047,6,60,54,6,1,14,14,-1.5,10,40
73,6,6,4952,-55,20,75,55,1,15,15,0,-50,60
73,7,7,3778,-15,60,75,15,1,15,15,2.866666667,-10,60
73,8,8,7037,-25,20,45,25,1,5,5,0.4,-30,40
73,9,9,7007,8,40,32,8,1,-28,28,5.75,10,60
73,10,10,4538,2,80,78,2,1,18,18,-17,10,60
73,11,11,5752,25,60,35,25,1,-5,5,-0.04,30,40
73,12,12,6309,46,80,34,46,1,-6,6,0,50,40
73,13,13,3830,16,60,44,16,1,-16,16,2.75,10,60
73,14,14,6176,-14,20,34,14,1,-6,6,-2.357142857,-10,40
73,15,15,4512,12,100,88,12,1,28,28,-1,10,60
73,16,16,3742,-27,40,67,27,1,27,27,0,-30,40
73,17,17,3808,-56,20,76,56,1,16,16,1.142857143,-50,60
73,18,18,4284,28,40,12,28,1,-48,48,2.714285714,30,60
73,19,19,3858,-67,0,67,67,1,27,27,0.492537313,-70,40
73,20,20,5217,46,80,34,46,1,-6,6,0.652173913,50,40
73,21,21,4408,12,100,88,12,1,28,28,-1.916666667,10,60
73,22,22,4426,-25,40,65,25,1,5,5,-1.36,-30,60
73,23,23,4250,-4,60,64,4,1,24,24,2.5,-10,40
73,24,24,4095,-79,20,99,79,1,39,39,0.746835443,-70,60
73,25,25,5652,-54,0,54,54,1,14,14,0.074074074,-50,40
73,26,26,4361,20,60,40,20,1,-20,20,1,10,60
73,27,27,6121,-30,20,50,30,1,10,10,-1,-30,40
73,28,28,4438,-40,40,80,40,1,40,40,,-50,40
73,29,29,4587,20,80,60,20,1,0,0,,10,60
73,30,0,6436,21,80,59,21,0,-1,1,-1.380952381,30,60
73,31,1,4695,-10,40,50,10,0,10,10,-0.9,-10,40
73,32,2,4882,1,60,59,1,0,19,19,-27,10,40
73,33,3,7007,10,40,30,10,0,-30,30,4.2,10,60
73,34,4,5621,-2,70,72,2,0,12,12,-4,-10,60
73,35,5,5341,-12,20,32,12,0,-8,8,-1.75,-10,40
73,36,6,7008,-23,30,53,23,0,13,13,0.826086957,-30,40
73,37,7,3995,-20,60,80,20,0,20,20,1.15,-10,60
73,38,8,3502,16,50,34,16,0,-6,6,3.375,10,40
73,39,9,4408,-7,50,57,7,0,-3,3,1.285714286,-10,60
73,40,10,4867,-68,20,88,68,0,48,48,0.794117647,-70,40
73,41,11,4178,2,50,48,2,0,-12,12,10,10,60
73,42,12,4002,2,70,68,2,0,8,8,-11.5,10,60
73,43,13,4137,-4,30,34,4,0,-6,6,3,-10,40
73,44,14,3638,15,60,45,15,0,-15,15,0,10,60
73,45,15,4259,28,50,22,28,0,-18,18,1.607142857,30,40
73,46,16,3934,35,80,45,35,0,-15,15,1,30,60
73,47,17,4485,-7,60,67,7,0,27,27,1.571428571,-10,40
73,48,18,4913,-40,40,80,40,0,20,20,0.25,-50,60
73,49,19,5163,-16,40,56,16,0,16,16,1.375,-10,40
73,50,20,4748,-20,50,70,20,0,10,10,0.1,-10,60
73,51,21,5356,2,70,68,2,0,8,8,4,10,60
73,52,22,5490,6,40,34,6,0,-6,6,5.166666667,10,40
73,53,23,6302,-15,50,65,15,0,25,25,0.666666667,-10,40
73,54,24,5737,4,80,76,4,0,16,16,-2.75,10,60
73,55,25,4201,-35,20,55,35,0,15,15,0.342857143,-30,40
73,56,26,4517,-13,30,43,13,0,3,3,-0.846153846,-10,40
73,57,27,3844,-5,60,65,5,0,5,5,-4.2,-10,60
73,58,28,3993,-46,40,86,46,0,26,26,,-50,60
73,59,29,4767,6,60,54,6,0,14,14,,10,40
74,0,0,4170,-40,20,60,40,1,20,20,0.75,-50,40
74,1,1,7005,40,100,60,40,1,0,0,0.25,50,60
74,2,2,5444,50,80,30,50,1,-10,10,0.6,50,40
74,3,3,5655,-50,20,70,50,1,10,10,0.8,-50,60
74,4,4,4978,0,60,60,0,1,20,20,,,40
74,5,5,5222,-20,40,60,20,1,20,20,-0.5,-10,40
74,6,6,3946,30,60,30,30,1,-30,30,0.333333333,30,60
74,7,7,3894,0,40,40,0,1,-20,20,,,60
74,8,8,5867,-70,0,70,70,1,30,30,0.571428571,-70,40
74,9,9,6209,30,80,50,30,1,-10,10,0.333333333,30,60
74,10,10,5909,20,80,60,20,1,0,0,0.5,10,60
74,11,11,4013,-10,20,30,10,1,-10,10,0,-10,40
74,12,12,4476,30,60,30,30,1,-10,10,0.333333333,30,40
74,13,13,3995,-30,40,70,30,1,10,10,1,-30,60
74,14,14,3630,0,40,40,0,1,0,0,,,40
74,15,15,3976,20,60,40,20,1,-20,20,-1,10,60
74,16,16,4428,-20,0,20,20,1,-20,20,0,-10,40
74,17,17,3592,0,20,20,0,1,-40,40,,,60
74,18,18,3522,80,100,20,80,1,-40,40,0.375,70,60
74,19,19,3558,60,80,20,60,1,-20,20,0.5,50,40
74,20,20,3932,10,60,50,10,1,10,10,-3,10,40
74,21,21,3490,50,100,50,50,1,-10,10,-0.2,50,60
74,22,22,5093,-20,20,40,20,1,-20,20,0,-10,60
74,23,23,6578,-20,0,20,20,1,-20,20,-1,-10,40
74,24,24,3541,40,80,40,40,1,-20,20,0,50,60
74,25,25,3574,0,40,40,0,1,0,0,,,40
74,26,26,3508,0,40,40,0,1,-20,20,,,60
74,27,27,4762,60,80,20,60,1,-20,20,0.5,50,40
74,28,28,4039,-30,20,50,30,1,10,10,,-30,40
74,29,29,6614,20,60,40,20,1,-20,20,,10,60
74,30,0,5472,20,70,50,20,0,-10,10,2,10,60
74,31,1,3756,20,60,40,20,0,0,0,0,10,40
74,32,2,4989,-10,30,40,10,0,0,0,1,-10,40
74,33,3,3948,-10,80,90,10,0,30,30,2,-10,60
74,34,4,5225,-20,50,70,20,0,10,10,0,-10,60
74,35,5,4154,10,40,30,10,0,-10,10,0.9,10,40
74,36,6,4317,-19,20,39,19,0,-1,1,-0.052631579,-10,40
74,37,7,3114,-30,40,70,30,0,10,10,0.666666667,-30,60
74,38,8,3057,10,50,40,10,0,0,0,2,10,40
74,39,9,3478,10,60,50,10,0,-10,10,-2,10,60
74,40,10,5188,-10,50,60,10,0,20,20,2,-10,40
74,41,11,3015,50,80,30,50,0,-30,30,0.8,50,60
74,42,12,3367,0,70,70,0,0,10,10,,,60
74,43,13,3590,-10,30,40,10,0,0,0,0,-10,40
74,44,14,3097,-10,50,60,10,0,0,0,3,-10,60
74,45,15,3164,-20,20,40,20,0,0,0,-1,-10,40
74,46,16,3135,30,60,30,30,0,-30,30,1.333333333,30,60
74,47,17,3416,0,60,60,0,0,20,20,,,40
74,48,18,3126,-30,40,70,30,0,10,10,1,-30,60
74,49,19,3224,0,40,40,0,0,0,0,,,40
74,50,20,3612,30,70,40,30,0,-20,20,0,30,60
74,51,21,2924,10,50,40,10,0,-20,20,1,10,60
74,52,22,7001,,60,,,0,,,,,40
74,53,23,3822,10,50,40,10,0,0,0,,10,40
74,54,24,2741,10,60,50,10,0,-10,10,-2,10,60
74,55,25,7005,,40,,,0,,,,,40
74,56,26,3109,-20,20,40,20,0,0,0,0,-10,40
74,57,27,5220,50,80,30,50,0,-30,30,0.8,50,60
74,58,28,2914,-30,40,70,30,0,10,10,,-30,60
74,59,29,2856,-10,30,40,10,0,0,0,,-10,40
75,0,0,7004,-70,20,90,70,1,50,50,0.857142857,-70,40
75,1,1,7037,30,80,50,30,1,-10,10,-0.333333333,30,60
75,2,2,7013,50,80,30,50,1,-10,10,0.8,50,40
75,3,3,7014,60,100,40,60,1,-20,20,0.833333333,50,60
75,4,4,7003,-30,40,70,30,1,30,30,0,-30,40
75,5,5,7003,-10,60,70,10,1,30,30,3,-10,40
75,6,6,7003,-30,60,90,30,1,30,30,2.333333333,-30,60
75,7,7,7001,20,40,20,20,1,-40,40,3,10,60
75,8,8,7018,-40,0,40,40,1,0,0,0,-50,40
75,9,9,7007,-60,20,80,60,1,20,20,-0.166666667,-50,60
75,10,10,7045,10,100,90,10,1,30,30,-4,10,60
75,11,11,7029,20,60,40,20,1,0,0,-1.5,10,40
75,12,12,7085,70,80,10,70,1,-30,30,0,70,40
75,13,13,7015,-10,40,50,10,1,-10,10,0,-10,60
75,14,14,7018,-10,0,10,10,1,-30,30,-7,-10,40
75,15,15,7003,10,60,50,10,1,-10,10,0,10,60
75,16,16,7025,-40,40,80,40,1,40,40,0.75,-50,40
75,17,17,7019,30,80,50,30,1,-10,10,1.333333333,30,60
75,18,18,7012,-70,20,90,70,1,30,30,0.142857143,-70,60
75,19,19,7017,-30,20,50,30,1,10,10,-0.666666667,-30,40
75,20,20,7003,-50,20,70,50,1,30,30,0.2,-50,40
75,21,21,7002,0,80,80,0,1,20,20,,,60
75,22,22,7001,40,60,20,40,1,-40,40,0.5,50,60
75,23,23,7016,-20,40,60,20,1,20,20,-1,-10,40
75,24,24,7017,60,100,40,60,1,-20,20,0,50,60
75,25,25,7004,0,80,80,0,1,40,40,,,40
75,26,26,7009,-20,20,40,20,1,-20,20,-1.5,-10,60
75,27,27,7003,-52,0,52,52,1,12,12,-0.538461538,-50,40
75,28,28,7044,-20,60,80,20,1,40,40,,-10,40
75,29,29,7006,-30,40,70,30,1,10,10,,-30,60
75,30,0,7009,50,60,10,50,0,-50,50,1,50,60
75,31,1,7004,20,60,40,20,0,0,0,1,10,40
75,32,2,7005,-10,50,60,10,0,20,20,0,-10,40
75,33,3,7035,-20,40,60,20,0,0,0,0.5,-10,60
75,34,4,7022,20,70,50,20,0,-10,10,0,10,60
75,35,5,7021,-20,40,60,20,0,20,20,1,-10,40
75,36,6,7001,-20,20,40,20,0,0,0,0,-10,40
75,37,7,7008,0,50,50,0,0,-10,10,,,60
75,38,8,7019,-10,30,40,10,0,0,0,-1,-10,40
75,39,9,7016,-10,80,90,10,0,30,30,1,-10,60
75,40,10,7002,10,60,50,10,0,10,10,-1,10,40
75,41,11,7025,-10,70,80,10,0,20,20,0,-10,60
75,42,12,7008,0,80,80,0,0,20,20,,,60
75,43,13,7003,10,50,40,10,0,0,0,1,10,40
75,44,14,7008,0,60,60,0,0,0,0,,,60
75,45,15,7017,-20,30,50,20,0,10,10,-0.5,-10,40
75,46,16,7028,-30,50,80,30,0,20,20,0.333333333,-30,60
75,47,17,7003,-40,20,60,40,0,20,20,0,-50,40
75,48,18,7018,-30,40,70,30,0,10,10,0.666666667,-30,60
75,49,19,7022,-20,40,60,20,0,20,20,1,-10,40
75,50,20,7009,0,50,50,0,0,-10,10,,,60
75,51,21,7011,10,70,60,10,0,0,0,-1,10,60
75,52,22,7015,20,60,40,20,0,0,0,1,10,40
75,53,23,7013,-30,30,60,30,0,20,20,1,-30,40
75,54,24,7058,10,60,50,10,0,-10,10,-1,10,60
75,55,25,7024,-10,20,30,10,0,-10,10,-1,-10,40
75,56,26,7032,0,40,40,0,0,0,0,,,40
75,57,27,7018,0,40,40,0,0,-20,20,,,60
75,58,28,7020,30,80,50,30,0,-10,10,,30,60
75,59,29,7014,-20,50,70,20,0,30,30,,-10,40
76,0,0,7015,20,60,40,20,0,-20,20,1,10,60
76,1,1,7007,-10,60,70,10,0,30,30,3,-10,40
76,2,2,9589,-20,20,40,20,0,0,0,0.5,-10,40
76,3,3,7015,10,70,60,10,0,0,0,2,10,60
76,4,4,7029,-40,40,80,40,0,20,20,0,-50,60
76,5,5,7015,10,40,30,10,0,-10,10,0,10,40
76,6,6,7025,0,30,30,0,0,-10,10,,,40
76,7,7,7009,-30,50,80,30,0,20,20,2,-30,60
76,8,8,7032,30,50,20,30,0,-20,20,0,30,40
76,9,9,7007,60,80,20,60,0,-40,40,0.666666667,50,60
76,10,10,7035,10,30,20,10,0,-20,20,5,10,40
76,11,11,7008,20,80,60,20,0,0,0,1.5,10,60
76,12,12,7021,-20,70,90,20,0,30,30,2,-10,60
76,13,13,7006,-20,50,70,20,0,30,30,0,-10,40
76,14,14,7030,-10,40,50,10,0,-10,10,1,-10,60
76,15,15,7008,-30,40,70,30,0,30,30,0.333333333,-30,40
76,16,16,7020,20,60,40,20,0,-20,20,0,10,60
76,17,17,7019,0,60,60,0,0,20,20,,,40
76,18,18,7024,10,50,40,10,0,-20,20,-1,10,60
76,19,19,7011,-20,20,40,20,0,0,0,0,-10,40
76,20,20,7013,10,40,30,10,0,-30,30,4,10,60
76,21,21,7016,-10,60,70,10,0,10,10,-1,-10,60
76,22,22,7027,10,50,40,10,0,0,0,-1,10,40
76,23,23,7011,-10,20,30,10,0,-10,10,-1,-10,40
76,24,24,7034,0,80,80,0,0,20,20,,,60
76,25,25,7016,-10,30,40,10,0,0,0,0,-10,40
76,26,26,7012,20,60,40,20,0,0,0,0,10,40
76,27,27,7019,-20,70,90,20,0,30,30,2.5,-10,60
76,28,28,7023,10,50,40,10,0,-20,20,,10,60
76,29,29,7020,0,40,40,0,0,0,0,,,40
76,30,0,7007,0,40,40,0,1,0,0,,,40
76,31,1,7014,10,40,30,10,1,-30,30,5,10,60
76,32,2,7019,10,80,70,10,1,30,30,-2,10,40
76,33,3,7023,-60,20,80,60,1,20,20,0.833333333,-50,60
76,34,4,7037,10,60,50,10,1,10,10,-1,10,40
76,35,5,7014,-40,0,40,40,1,0,0,0,-50,40
76,36,6,7032,30,60,30,30,1,-30,30,0,30,60
76,37,7,7014,50,80,30,50,1,-30,30,0.6,50,60
76,38,8,7015,-20,20,40,20,1,0,0,0.5,-10,40
76,39,9,7007,40,100,60,40,1,0,0,0,50,60
76,40,10,7019,-40,20,60,40,1,0,0,0.5,-50,60
76,41,11,7013,50,80,30,50,1,-10,10,-0.2,50,40
76,42,12,7012,0,20,20,0,1,-20,20,,,40
76,43,13,7018,60,100,40,60,1,-20,20,0,50,60
76,44,14,7024,-70,0,70,70,1,30,30,-0.428571429,-70,40
76,45,15,7023,40,80,40,40,1,-20,20,0,50,60
76,46,16,7024,-40,60,100,40,1,60,60,1.75,-50,40
76,47,17,7004,20,60,40,20,1,-20,20,-0.5,10,60
76,48,18,7019,10,40,30,10,1,-30,30,1,10,60
76,49,19,7021,10,40,30,10,1,-10,10,1,10,40
76,50,20,7029,-20,20,40,20,1,0,0,0,-10,40
76,51,21,7003,-20,20,40,20,1,-20,20,-2,-10,60
76,52,22,7015,20,100,80,20,1,20,20,-2,10,60
76,53,23,7021,20,60,40,20,1,0,0,2,10,40
76,54,24,7023,40,80,40,40,1,-20,20,1,50,60
76,55,25,7014,-80,0,80,80,1,40,40,0.375,-70,40
76,56,26,7028,-20,60,80,20,1,20,20,0,-10,60
76,57,27,7017,30,80,50,30,1,10,10,0.666666667,30,40
76,58,28,7006,-30,40,70,30,1,30,30,,-30,40
76,59,29,7005,-40,40,80,40,1,20,20,,-50,60
77,0,0,4802,10,80,70,10,0,10,10,0,10,60
77,1,1,4152,10,50,40,10,0,0,0,0,10,40
77,2,2,4259,-10,30,40,10,0,0,0,-1,-10,40
77,3,3,4892,-10,60,70,10,0,10,10,0,-10,60
77,4,4,4033,0,70,70,0,0,10,10,,,60
77,5,5,4033,10,60,50,10,0,10,10,-1,10,40
77,6,6,4551,0,40,40,0,0,0,0,,,40
77,7,7,4126,-30,40,70,30,0,10,10,0,-30,60
77,8,8,5667,-30,20,50,30,0,10,10,1,-30,40
77,9,9,3693,-20,50,70,20,0,10,10,1,-10,60
77,10,10,4173,40,60,20,40,0,-20,20,0,50,40
77,11,11,3467,0,50,50,0,0,-10,10,,,60
77,12,12,4136,10,80,70,10,0,10,10,1,10,60
77,13,13,4801,0,20,20,0,0,-20,20,,,40
77,14,14,4604,-40,40,80,40,0,20,20,0.75,-50,60
77,15,15,4442,0,40,40,0,0,0,0,,,40
77,16,16,3706,10,60,50,10,0,-10,10,1,10,60
77,17,17,4100,20,50,30,20,0,-10,10,0,10,40
77,18,18,4167,10,70,60,10,0,0,0,-3,10,60
77,19,19,4716,0,30,30,0,0,-10,10,,,40
77,20,20,4873,30,60,30,30,0,-30,30,1.333333333,30,60
77,21,21,4131,-20,50,70,20,0,10,10,1,-10,60
77,22,22,4474,30,60,30,30,0,-10,10,0,30,40
77,23,23,4480,10,40,30,10,0,-10,10,0,10,40
77,24,24,4721,20,70,50,20,0,-10,10,1,10,60
77,25,25,4146,0,30,30,0,0,-10,10,,,40
77,26,26,4278,-10,20,30,10,0,-10,10,1,-10,40
77,27,27,3629,-30,40,70,30,0,10,10,0,-30,60
77,28,28,4818,10,80,70,10,0,10,10,,10,60
77,29,29,4261,30,50,20,30,0,-20,20,,30,40
77,30,0,4936,-40,20,60,40,1,20,20,0.75,-50,40
77,31,1,4304,40,100,60,40,1,0,0,0.5,50,60
77,32,2,4141,10,40,30,10,1,-10,10,-1,10,40
77,33,3,4583,-60,20,80,60,1,20,20,0.833333333,-50,60
77,34,4,4252,40,60,20,40,1,-20,20,0.75,50,40
77,35,5,4307,-50,0,50,50,1,10,10,0.6,-50,40
77,36,6,6096,10,40,30,10,1,-30,30,-2,10,60
77,37,7,4365,70,80,10,70,1,-50,50,1.142857143,70,60
77,38,8,4574,60,80,20,60,1,-20,20,-0.166666667,50,40
77,39,9,4156,-30,60,90,30,1,30,30,1,-30,60
77,40,10,4270,-20,40,60,20,1,0,0,-0.5,-10,60
77,41,11,5447,50,60,10,50,1,-30,30,0.8,50,40
77,42,12,5098,30,80,50,30,1,10,10,-0.333333333,30,40
77,43,13,3802,30,100,70,30,1,10,10,-0.333333333,30,60
77,44,14,3905,-40,0,40,40,1,0,0,-0.25,-50,40
77,45,15,4351,-40,20,60,40,1,0,0,-1,-50,60
77,46,16,5053,-30,20,50,30,1,10,10,0,-30,40
77,47,17,5685,-40,60,100,40,1,40,40,0.25,-50,60
77,48,18,4353,-10,80,90,10,1,30,30,2,-10,60
77,49,19,5158,-10,40,50,10,1,10,10,1,-10,40
77,50,20,4768,20,60,40,20,1,0,0,-0.5,10,40
77,51,21,4574,-30,40,70,30,1,10,10,-0.666666667,-30,60
77,52,22,3761,-10,80,90,10,1,30,30,0,-10,60
77,53,23,4060,-10,20,30,10,1,-10,10,-1,-10,40
77,54,24,4358,10,100,90,10,1,30,30,-1,10,60
77,55,25,3739,40,80,40,40,1,0,0,0,50,40
77,56,26,4580,-60,20,80,60,1,20,20,-0.166666667,-50,60
77,57,27,4521,0,40,40,0,1,0,0,,,40
77,58,28,5003,-10,0,10,10,1,-30,30,,-10,40
77,59,29,4093,-30,60,90,30,1,30,30,,-30,60
78,0,0,5712,-70,0,70,70,1,30,30,0.714285714,-70,40
78,1,1,3350,20,100,80,20,1,20,20,-1.5,10,60
78,2,2,5245,40,60,20,40,1,-20,20,2,50,40
78,3,3,4272,-10,40,50,10,1,-10,10,0,-10,60
78,4,4,5303,-20,80,100,20,1,60,60,1.5,-10,40
78,5,5,3411,-50,20,70,50,1,30,30,0.6,-50,40
78,6,6,5477,10,60,50,10,1,-10,10,3,10,60
78,7,7,3049,-60,20,80,60,1,20,20,0.833333333,-50,60
78,8,8,4383,0,40,40,0,1,0,0,,,40
78,9,9,5687,50,80,30,50,1,-30,30,1,50,60
78,10,10,3289,20,100,80,20,1,20,20,-2,10,60
78,11,11,3879,10,40,30,10,1,-10,10,0,10,40
78,12,12,3623,-30,0,30,30,1,-10,10,0,-30,40
78,13,13,3666,-20,20,40,20,1,-20,20,-2,-10,60
78,14,14,4244,30,60,30,30,1,-10,10,1.666666667,30,40
78,15,15,2982,-20,60,80,20,1,20,20,3,-10,60
78,16,16,2956,0,80,80,0,1,40,40,,,40
78,17,17,2835,20,40,20,20,1,-40,40,0.5,10,60
78,18,18,2853,50,80,30,50,1,-30,30,1,50,60
78,19,19,2886,20,20,0,20,1,-40,40,1,10,40
78,20,20,4732,20,40,20,20,1,-20,20,-0.5,10,40
78,21,21,2854,-20,60,80,20,1,20,20,1.5,-10,60
78,22,22,4087,-30,20,50,30,1,-10,10,-1,-30,60
78,23,23,2989,70,80,10,70,1,-30,30,0,70,40
78,24,24,4048,20,100,80,20,1,20,20,0,10,60
78,25,25,3365,10,20,10,10,1,-30,30,1,10,40
78,26,26,3615,0,80,80,0,1,20,20,,,60
78,27,27,2851,40,60,20,40,1,-20,20,0.75,50,40
78,28,28,4150,-50,0,50,50,1,10,10,,-50,40
78,29,29,3283,-30,40,70,30,1,10,10,,-30,60
78,30,0,3621,-50,50,100,50,0,40,40,0.4,-50,60
78,31,1,4375,-30,20,50,30,0,10,10,0,-30,40
78,32,2,3910,-20,30,50,20,0,10,10,1.5,-10,40
78,33,3,3577,0,80,80,0,0,20,20,,,60
78,34,4,3228,-30,40,70,30,0,10,10,0.333333333,-30,60
78,35,5,3131,20,40,20,20,0,-20,20,0.5,10,40
78,36,6,2812,30,60,30,30,0,-10,10,-0.666666667,30,40
78,37,7,3884,0,60,60,0,0,0,0,,,60
78,38,8,3000,40,50,10,40,0,-30,30,0.75,50,40
78,39,9,3659,0,70,70,0,0,10,10,,,60
78,40,10,2925,20,60,40,20,0,0,0,-1,10,40
78,41,11,3012,-10,80,90,10,0,30,30,2,-10,60
78,42,12,3746,-30,40,70,30,0,10,10,0,-30,60
78,43,13,4156,0,20,20,0,0,-20,20,,,40
78,44,14,2880,-20,50,70,20,0,10,10,0.5,-10,60
78,45,15,2878,10,30,20,10,0,-20,20,-1,10,40
78,46,16,2827,10,70,60,10,0,0,0,0,10,60
78,47,17,4202,30,40,10,30,0,-30,30,0.333333333,30,40
78,48,18,3547,0,60,60,0,0,0,0,,,60
78,49,19,2701,30,50,20,30,0,-20,20,0.333333333,30,40
78,50,20,2877,-20,40,60,20,0,0,0,-1,-10,60
78,51,21,3004,-30,50,80,30,0,20,20,0.333333333,-30,60
78,52,22,3860,20,50,30,20,0,-10,10,-0.5,10,40
78,53,23,3863,10,30,20,10,0,-20,20,-1,10,40
78,54,24,3502,10,80,70,10,0,10,10,-1,10,60
78,55,25,2654,30,40,10,30,0,-30,30,0.666666667,30,40
78,56,26,2973,-10,20,30,10,0,-10,10,2,-10,40
78,57,27,2712,0,60,60,0,0,0,0,,,60
78,58,28,3849,10,70,60,10,0,0,0,,10,60
78,59,29,2990,50,60,10,50,0,-30,30,,50,40
79,0,0,4181,0,50,50,0,0,-10,10,,,60
79,1,1,4353,-20,50,70,20,0,30,30,0,-10,40
79,2,2,4213,-30,40,70,30,0,30,30,1,-30,40
79,3,3,4547,-20,60,80,20,0,20,20,1,-10,60
79,4,4,4845,10,70,60,10,0,0,0,2,10,60
79,5,5,4342,-10,30,40,10,0,0,0,0,-10,40
79,6,6,5778,-20,20,40,20,0,0,0,0,-10,40
79,7,7,5273,0,80,80,0,0,20,20,,,60
79,8,8,4592,20,60,40,20,0,0,0,0.5,10,40
79,9,9,5646,-40,40,80,40,0,20,20,0.25,-50,60
79,10,10,4902,10,60,50,10,0,10,10,0,10,40
79,11,11,4260,-30,40,70,30,0,10,10,0.333333333,-30,60
79,12,12,4522,10,70,60,10,0,0,0,0,10,60
79,13,13,5186,-10,40,50,10,0,10,10,2,-10,40
79,14,14,4302,20,80,60,20,0,0,0,0.5,10,60
79,15,15,4278,-10,20,30,10,0,-10,10,-1,-10,40
79,16,16,4227,-20,50,70,20,0,10,10,0,-10,60
79,17,17,3835,10,50,40,10,0,0,0,-1,10,40
79,18,18,4784,-10,60,70,10,0,10,10,-1,-10,60
79,19,19,5265,0,30,30,0,0,-10,10,,,40
79,20,20,4186,-20,60,80,20,0,20,20,0.5,-10,60
79,21,21,4308,10,80,70,10,0,10,10,0,10,60
79,22,22,3944,20,50,30,20,0,-10,10,0.5,10,40
79,23,23,5094,-20,20,40,20,0,0,0,-0.5,-10,40
79,24,24,4159,-30,40,70,30,0,10,10,0.333333333,-30,60
79,25,25,5269,10,60,50,10,0,10,10,-2,10,40
79,26,26,4548,10,40,30,10,0,-10,10,0,10,40
79,27,27,5301,-10,50,60,10,0,0,0,0,-10,60
79,28,28,4289,10,70,60,10,0,0,0,,10,60
79,29,29,4775,0,30,30,0,0,-10,10,,,40
79,30,0,4807,50,80,30,50,1,-10,10,0.8,50,40
79,31,1,4897,-20,20,40,20,1,-20,20,0,-10,60
79,32,2,4550,-70,0,70,70,1,30,30,-0.142857143,-70,40
79,33,3,4191,20,60,40,20,1,-20,20,1,10,60
79,34,4,5692,-60,20,80,60,1,40,40,1,-50,40
79,35,5,4940,20,40,20,20,1,-20,20,0.5,10,40
79,36,6,4274,20,80,60,20,1,0,0,-0.5,10,60
79,37,7,4596,50,100,50,50,1,-10,10,0.6,50,60
79,38,8,4316,30,60,30,30,1,-10,10,0,30,40
79,39,9,4423,-40,40,80,40,1,20,20,0.5,-50,60
79,40,10,4641,0,60,60,0,1,0,0,,,60
79,41,11,4935,-10,20,30,10,1,-10,10,-1,-10,40
79,42,12,4600,20,60,40,20,1,0,0,-0.5,10,40
79,43,13,4537,-20,40,60,20,1,0,0,1,-10,60
79,44,14,4233,50,80,30,50,1,-10,10,0,50,40
79,45,15,4421,40,80,40,40,1,-20,20,0.25,50,60
79,46,16,4698,-30,0,30,30,1,-10,10,-0.666666667,-30,40
79,47,17,4276,-30,20,50,30,1,-10,10,0,-30,60
79,48,18,4855,50,100,50,50,1,-10,10,0.4,50,60
79,49,19,4519,-10,40,50,10,1,10,10,2,-10,40
79,50,20,4214,50,80,30,50,1,-10,10,0,50,40
79,51,21,4331,10,80,70,10,1,10,10,-3,10,60
79,52,22,6033,20,60,40,20,1,-20,20,1.5,10,60
79,53,23,5153,-10,20,30,10,1,-10,10,3,-10,40
79,54,24,4945,30,100,70,30,1,10,10,-0.333333333,30,60
79,55,25,5191,0,0,0,0,1,-40,40,,,40
79,56,26,4410,-20,40,60,20,1,0,0,0.5,-10,60
79,57,27,5761,10,40,30,10,1,-10,10,0,10,40
79,58,28,4976,30,60,30,30,1,-10,10,,30,40
79,59,29,5167,-30,20,50,30,1,-10,10,,-30,60
80,0,0,4936,10,60,50,10,1,10,10,2,10,40
80,1,1,3563,-10,20,30,10,1,-30,30,0,-10,60
80,2,2,3396,-50,20,70,50,1,30,30,0.8,-50,40
80,3,3,2897,50,80,30,50,1,-30,30,0.6,50,60
80,4,4,4721,50,80,30,50,1,-10,10,0.8,50,40
80,5,5,3109,-70,0,70,70,1,30,30,0,-70,40
80,6,6,2934,0,60,60,0,1,0,0,,,60
80,7,7,3537,-10,40,50,10,1,-10,10,0,-10,60
80,8,8,3640,-30,40,70,30,1,30,30,-0.666666667,-30,40
80,9,9,3572,50,100,50,50,1,-10,10,0.6,50,60
80,10,10,3521,20,100,80,20,1,20,20,-2.5,10,60
80,11,11,4003,-10,80,90,10,1,50,50,2,-10,40
80,12,12,3574,-10,60,70,10,1,30,30,-1,-10,40
80,13,13,4520,10,40,30,10,1,-30,30,3,10,60
80,14,14,4186,-40,40,80,40,1,40,40,0,-50,40
80,15,15,3813,-40,20,60,40,1,0,0,1,-50,60
80,16,16,3753,-80,0,80,80,1,40,40,,-70,40
80,17,17,4062,60,80,20,60,1,-40,40,0.666666667,50,60
80,18,18,3077,0,60,60,0,1,0,0,,,60
80,19,19,7001,,20,,,1,,,,,40
80,20,20,3143,-10,20,30,10,1,-10,10,0,-10,40
80,21,21,3633,20,60,40,20,1,-20,20,1,10,60
80,22,22,3204,20,80,60,20,1,0,0,-1,10,60
80,23,23,11688,50,80,30,50,1,-10,10,0.6,50,40
80,24,24,5581,0,40,40,0,1,-20,20,,,60
80,25,25,3686,-60,0,60,60,1,20,20,-0.333333333,-50,40
80,26,26,3041,50,100,50,50,1,-10,10,-0.6,50,60
80,27,27,3205,-40,40,80,40,1,40,40,0,-50,40
80,28,28,3091,-20,60,80,20,1,40,40,,-10,40
80,29,29,4944,0,20,20,0,1,-40,40,,,60
80,30,0,3362,10,70,60,10,0,0,0,-2,10,60
80,31,1,3762,-10,40,50,10,0,10,10,-2,-10,40
80,32,2,3736,-10,60,70,10,0,30,30,4,-10,40
80,33,3,5055,0,40,40,0,0,-20,20,,,60
80,34,4,3029,-10,60,70,10,0,10,10,2,-10,60
80,35,5,4097,-10,20,30,10,0,-10,10,0,-10,40
80,36,6,2895,20,50,30,20,0,-10,10,2,10,40
80,37,7,3450,30,80,50,30,0,-10,10,-0.333333333,30,60
80,38,8,3084,-40,30,70,40,0,30,30,0.75,-50,40
80,39,9,2928,10,50,40,10,0,-20,20,4,10,60
80,40,10,3156,10,50,40,10,0,0,0,-1,10,40
80,41,11,2532,-20,60,80,20,0,20,20,2,-10,60
80,42,12,3986,10,50,40,10,0,-20,20,5,10,60
80,43,13,3140,10,40,30,10,0,-10,10,1,10,40
80,44,14,2791,-50,40,90,50,0,30,30,0.2,-50,60
80,45,15,3163,-20,20,40,20,0,0,0,-1,-10,40
80,46,16,2896,0,80,80,0,0,20,20,,,60
80,47,17,3895,-30,30,60,30,0,20,20,1,-30,40
80,48,18,4486,10,70,60,10,0,0,0,2,10,60
80,49,19,4875,30,60,30,30,0,-10,10,0.333333333,30,40
80,50,20,2841,-40,40,80,40,0,20,20,0.5,-50,60
80,51,21,3106,20,80,60,20,0,0,0,-1.5,10,60
80,52,22,4674,0,40,40,0,0,0,0,,,40
80,53,23,3365,10,30,20,10,0,-20,20,4,10,40
80,54,24,3198,30,60,30,30,0,-30,30,1.333333333,30,60
80,55,25,3057,-10,50,60,10,0,20,20,3,-10,40
80,56,26,3634,-10,20,30,10,0,-10,10,-1,-10,40
80,57,27,2947,-20,50,70,20,0,10,10,2.5,-10,60
80,58,28,3044,50,70,20,50,0,-40,40,,50,60
80,59,29,2814,20,60,40,20,0,0,0,,10,40
81,0,0,4225,30,80,50,30,1,10,10,0.666666667,30,40
81,1,1,4816,40,60,20,40,1,-40,40,0.5,50,60
81,2,2,3604,-10,60,70,10,1,30,30,0,-10,40
81,3,3,4005,40,80,40,40,1,-20,20,0.5,50,60
81,4,4,4649,-30,40,70,30,1,30,30,1.333333333,-30,40
81,5,5,3893,-30,0,30,30,1,-10,10,0,-30,40
81,6,6,4454,40,100,60,40,1,0,0,0.5,50,60
81,7,7,3463,-60,20,80,60,1,20,20,0.333333333,-50,60
81,8,8,3795,-10,20,30,10,1,-10,10,-2,-10,40
81,9,9,4659,-20,40,60,20,1,0,0,-0.5,-10,60
81,10,10,3751,-10,60,70,10,1,10,10,1,-10,60
81,11,11,5064,-30,20,50,30,1,10,10,1.333333333,-30,40
81,12,12,3954,-10,0,10,10,1,-30,30,-1,-10,40
81,13,13,4780,20,80,60,20,1,0,0,1,10,60
81,14,14,4389,20,40,20,20,1,-20,20,0,10,40
81,15,15,3801,20,100,80,20,1,20,20,0.25,10,60
81,16,16,3811,40,60,20,40,1,-20,20,0.25,50,40
81,17,17,4857,-45,40,85,45,1,25,25,-0.333333333,-50,60
81,18,18,3630,-80,20,100,80,1,40,40,0.625,-70,60
81,19,19,3384,50,80,30,50,1,-10,10,0,50,40
81,20,20,4786,30,60,30,30,1,-10,10,-0.333333333,30,40
81,21,21,5493,-10,40,50,10,1,-10,10,-2,-10,60
81,22,22,4361,-10,60,70,10,1,10,10,0,-10,60
81,23,23,4519,-20,0,20,20,1,-20,20,0,-10,40
81,24,24,4720,30,100,70,30,1,10,10,-0.666666667,30,60
81,25,25,3649,0,20,20,0,1,-20,20,,,40
81,26,26,2786,-30,20,50,30,1,-10,10,-0.666666667,-30,60
81,27,27,2742,10,40,30,10,1,-10,10,-2,10,40
81,28,28,2941,70,80,10,70,1,-30,30,,70,40
81,29,29,3732,10,80,70,10,1,10,10,,10,60
81,30,0,3216,0,50,50,0,0,-10,10,,,60
81,31,1,2919,50,60,10,50,0,-30,30,0.2,50,40
81,32,2,3842,30,50,20,30,0,-20,20,0.333333333,30,40
81,33,3,2811,10,80,70,10,0,10,10,2,10,60
81,34,4,3485,-20,70,90,20,0,30,30,1,-10,60
81,35,5,2791,-10,20,30,10,0,-10,10,-1,-10,40
81,36,6,3224,0,40,40,0,0,0,0,,,40
81,37,7,2784,-10,60,70,10,0,10,10,1,-10,60
81,38,8,3209,10,30,20,10,0,-20,20,2,10,40
81,39,9,3300,-20,40,60,20,0,0,0,-1,-10,60
81,40,10,3805,20,60,40,20,0,0,0,-1.5,10,40
81,41,11,2731,0,80,80,0,0,20,20,,,60
81,42,12,2889,0,60,60,0,0,0,0,,,60
81,43,13,2772,20,30,10,20,0,-30,30,1,10,40
81,44,14,2938,20,70,50,20,0,-10,10,1,10,60
81,45,15,3391,-10,20,30,10,0,-10,10,-1,-10,40
81,46,16,2781,-30,40,70,30,0,10,10,-0.333333333,-30,60
81,47,17,2721,0,40,40,0,0,0,0,,,40
81,48,18,2795,-30,50,80,30,0,20,20,0.666666667,-30,60
81,49,19,2747,40,50,10,40,0,-30,30,0.25,50,40
81,50,20,3257,0,60,60,0,0,0,0,,,60
81,51,21,2810,-10,40,50,10,0,-10,10,-2,-10,60
81,52,22,3285,40,60,20,40,0,-20,20,0.5,50,40
81,53,23,3023,10,50,40,10,0,0,0,0,10,40
81,54,24,2966,-20,50,70,20,0,10,10,1.5,-10,60
81,55,25,2986,-10,30,40,10,0,0,0,1,-10,40
81,56,26,2804,-10,20,30,10,0,-10,10,0,-10,40
81,57,27,2951,40,80,40,40,0,-20,20,0.75,50,60
81,58,28,2859,0,70,70,0,0,10,10,,,60
81,59,29,2710,10,40,30,10,0,-10,10,,10,40
82,0,0,4061,-40,40,80,40,0,20,20,-0.25,-50,60
82,1,1,2941,-10,40,50,10,0,10,10,-1,-10,40
82,2,2,2773,-30,30,60,30,0,20,20,1.333333333,-30,40
82,3,3,3406,-30,60,90,30,0,30,30,1,-30,60
82,4,4,2567,20,80,60,20,0,0,0,0.5,10,60
82,5,5,2686,30,50,20,30,0,-20,20,0.333333333,30,40
82,6,6,3013,-10,20,30,10,0,-10,10,1,-10,40
82,7,7,3814,0,70,70,0,0,10,10,,,60
82,8,8,2574,40,60,20,40,0,-20,20,1.5,50,40
82,9,9,2503,0,50,50,0,0,-10,10,,,60
82,10,10,2916,-40,40,80,40,0,40,40,1,-50,40
82,11,11,3253,-20,60,80,20,0,20,20,1.5,-10,60
82,12,12,3270,30,80,50,30,0,-10,10,-1,30,60
82,13,13,2709,20,60,40,20,0,0,0,-0.5,10,40
82,14,14,2918,30,50,20,30,0,-40,40,0.666666667,30,60
82,15,15,2902,-10,20,30,10,0,-10,10,-3,-10,40
82,16,16,2749,0,40,40,0,0,-20,20,,,60
82,17,17,3767,-30,30,60,30,0,20,20,1,-30,40
82,18,18,4302,50,70,20,50,0,-40,40,0,50,60
82,19,19,5823,20,50,30,20,0,-10,10,0.5,10,40
82,20,20,3678,30,50,20,30,0,-40,40,2,30,60
82,21,21,3414,-10,70,80,10,0,20,20,6,-10,60
82,22,22,2838,-10,30,40,10,0,0,0,1,-10,40
82,23,23,2782,-10,20,30,10,0,-10,10,0,-10,40
82,24,24,2982,40,60,20,40,0,-40,40,1,50,60
82,25,25,2702,10,40,30,10,0,-10,10,2,10,40
82,26,26,2734,10,60,50,10,0,10,10,-2,10,40
82,27,27,2574,20,80,60,20,0,0,0,-1.5,10,60
82,28,28,4734,10,40,30,10,0,-30,30,,10,60
82,29,29,2533,20,50,30,20,0,-10,10,,10,40
82,30,0,7004,,60,,,1,,,,,40
82,31,1,3277,50,80,30,50,1,-30,30,-0.2,50,60
82,32,2,2686,-30,20,50,30,1,10,10,0.666666667,-30,40
82,33,3,2966,0,20,20,0,1,-40,40,,,60
82,34,4,2694,-30,0,30,30,1,-10,10,1,-30,40
82,35,5,2502,80,80,0,80,1,-40,40,0.25,70,40
82,36,6,3560,70,100,30,70,1,-30,30,0.428571429,70,60
82,37,7,3204,0,60,60,0,1,0,0,,,60
82,38,8,2782,20,40,20,20,1,-20,20,1.5,10,40
82,39,9,2718,0,40,40,0,1,-20,20,,,60
82,40,10,2909,40,60,20,40,1,-40,40,0,50,60
82,41,11,2597,-30,20,50,30,1,10,10,0.333333333,-30,40
82,42,12,2892,20,60,40,20,1,0,0,0.5,10,40
82,43,13,3174,20,40,20,20,1,-40,40,2,10,60
82,44,14,3118,30,80,50,30,1,10,10,1,30,40
82,45,15,3285,20,80,60,20,1,0,0,-0.5,10,60
82,46,16,2662,-80,0,80,80,1,40,40,0.625,-70,40
82,47,17,4598,50,100,50,50,1,-10,10,0,50,60
82,48,18,3817,-30,20,50,30,1,-10,10,0.333333333,-30,60
82,49,19,2638,10,40,30,10,1,-10,10,4,10,40
82,50,20,2989,-30,40,70,30,1,30,30,2.333333333,-30,40
82,51,21,3646,0,40,40,0,1,-20,20,,,60
82,52,22,2750,60,80,20,60,1,-40,40,0.5,50,60
82,53,23,2998,20,20,0,20,1,-40,40,2.5,10,40
82,54,24,5055,-30,20,50,30,1,-10,10,0.666666667,-30,60
82,55,25,4733,30,80,50,30,1,10,10,0,30,40
82,56,26,3158,30,60,30,30,1,-30,30,0.333333333,30,60
82,57,27,4118,-50,0,50,50,1,10,10,1,-50,40
82,58,28,2215,60,60,0,60,1,-40,40,,50,40
82,59,29,3006,60,100,40,60,1,-20,20,,50,60
83,0,0,3482,-30,40,70,30,1,30,30,0,-30,40
83,1,1,3766,-30,40,70,30,1,10,10,0.333333333,-30,60
83,2,2,3792,-50,20,70,50,1,30,30,0.8,-50,40
83,3,3,3148,0,60,60,0,1,0,0,,,60
83,4,4,3969,30,60,30,30,1,-10,10,0.666666667,30,40
83,5,5,2795,30,80,50,30,1,10,10,0,30,40
83,6,6,2562,50,100,50,50,1,-10,10,0.6,50,60
83,7,7,2744,-60,20,80,60,1,20,20,0.333333333,-50,60
83,8,8,2683,-50,0,50,50,1,10,10,0.2,-50,40
83,9,9,3222,20,80,60,20,1,0,0,0.5,10,60
83,10,10,2795,10,80,70,10,1,10,10,-2,10,60
83,11,11,3148,0,40,40,0,1,0,0,,,40
83,12,12,3389,50,80,30,50,1,-10,10,0,50,40
83,13,13,4331,-10,40,50,10,1,-10,10,-3,-10,60
83,14,14,2890,-30,0,30,30,1,-10,10,-0.666666667,-30,40
83,15,15,3365,-20,60,80,20,1,20,20,-0.5,-10,60
83,16,16,3517,10,60,50,10,1,10,10,-1,10,40
83,17,17,2602,-70,20,90,70,1,30,30,0.142857143,-70,60
83,18,18,2706,20,100,80,20,1,20,20,0,10,60
83,19,19,4059,-20,20,40,20,1,0,0,-0.5,-10,40
83,20,20,2570,30,80,50,30,1,10,10,-1,30,40
83,21,21,3289,-40,40,80,40,1,20,20,0,-50,60
83,22,22,3959,0,80,80,0,1,20,20,,,60
83,23,23,3366,0,20,20,0,1,-20,20,,,40
83,24,24,3566,10,60,50,10,1,-10,10,4,10,60
83,25,25,4747,30,60,30,30,1,-10,10,1,30,40
83,26,26,2587,-70,20,90,70,1,30,30,0.285714286,-70,60
83,27,27,2891,-20,40,60,20,1,20,20,1,-10,40
83,28,28,3250,-40,0,40,40,1,0,0,,-50,40
83,29,29,2613,30,100,70,30,1,10,10,,30,60
83,30,0,3384,-10,40,50,10,0,-10,10,-1,-10,60
83,31,1,2666,-20,30,50,20,0,10,10,0.5,-10,40
83,32,2,2656,10,50,40,10,0,0,0,-2,10,40
83,33,3,3631,0,60,60,0,0,0,0,,,60
83,34,4,2638,20,70,50,20,0,-10,10,1,10,60
83,35,5,2646,0,20,20,0,0,-20,20,,,40
83,36,6,2721,-20,40,60,20,0,20,20,1,-10,40
83,37,7,2673,-20,50,70,20,0,10,10,0,-10,60
83,38,8,2990,20,60,40,20,0,0,0,-0.5,10,40
83,39,9,2850,10,80,70,10,0,10,10,-1,10,60
83,40,10,2792,20,50,30,20,0,-10,10,0.5,10,40
83,41,11,2599,-10,50,60,10,0,0,0,-3,-10,60
83,42,12,2651,-30,60,90,30,0,30,30,0,-30,60
83,43,13,2564,-10,30,40,10,0,0,0,-1,-10,40
83,44,14,2614,-10,80,90,10,0,30,30,2,-10,60
83,45,15,4327,-10,40,50,10,0,10,10,1,-10,40
83,46,16,3098,-30,40,70,30,0,10,10,0.333333333,-30,60
83,47,17,2728,-20,20,40,20,0,0,0,1,-10,40
83,48,18,4267,10,70,60,10,0,0,0,1,10,60
83,49,19,2634,40,60,20,40,0,-20,20,0.5,50,40
83,50,20,2855,-20,50,70,20,0,10,10,0.5,-10,60
83,51,21,2617,20,80,60,20,0,0,0,0.5,10,60
83,52,22,2850,20,60,40,20,0,0,0,0,10,40
83,53,23,4634,10,50,40,10,0,0,0,4,10,40
83,54,24,3634,-10,60,70,10,0,10,10,0,-10,60
83,55,25,3805,-50,30,80,50,0,40,40,0.8,-50,40
83,56,26,3445,0,40,40,0,0,0,0,,,40
83,57,27,3879,0,70,70,0,0,10,10,,,60
83,58,28,4105,-40,40,80,40,0,20,20,,-50,60
83,59,29,3439,-20,20,40,20,0,0,0,,-10,40
84,0,0,4988,20,50,30,20,0,-30,30,2.5,10,60
84,1,1,3083,-10,40,50,10,0,10,10,-1,-10,40
84,2,2,3689,-40,20,60,40,0,20,20,0.75,-50,40
84,3,3,3461,0,80,80,0,0,20,20,,,60
84,4,4,2873,-10,70,80,10,0,20,20,1,-10,60
84,5,5,5156,0,30,30,0,0,-10,10,,,40
84,6,6,3485,-30,60,90,30,0,50,50,2.333333333,-30,40
84,7,7,3033,-30,40,70,30,0,10,10,0.666666667,-30,60
84,8,8,4158,30,50,20,30,0,-20,20,1,30,40
84,9,9,4194,10,60,50,10,0,-10,10,-1,10,60
84,10,10,4040,-30,20,50,30,0,10,10,0,-30,40
84,11,11,2738,10,50,40,10,0,-20,20,-1,10,60
84,12,12,2706,10,40,30,10,0,-30,30,4,10,60
84,13,13,2952,-20,30,50,20,0,10,10,0.5,-10,40
84,14,14,4112,0,70,70,0,0,10,10,,,60
84,15,15,3280,10,50,40,10,0,0,0,2,10,40
84,16,16,2986,20,80,60,20,0,0,0,0,10,60
84,17,17,4600,-20,40,60,20,0,20,20,1,-10,40
84,18,18,3687,0,60,60,0,0,0,0,,,60
84,19,19,4221,20,60,40,20,0,0,0,2,10,40
84,20,20,2784,0,50,50,0,0,-10,10,,,60
84,21,21,5768,40,70,30,40,0,-30,30,0.5,50,60
84,22,22,3051,-60,20,80,60,0,40,40,0.833333333,-50,40
84,23,23,4178,10,40,30,10,0,-10,10,-1,10,40
84,24,24,2601,10,60,50,10,0,-10,10,2,10,60
84,25,25,5347,30,50,20,30,0,-20,20,2,30,40
84,26,26,3030,-20,60,80,20,0,40,40,2.5,-10,40
84,27,27,2906,10,80,70,10,0,10,10,-2,10,60
84,28,28,3138,-10,40,50,10,0,-10,10,,-10,60
84,29,29,3464,0,30,30,0,0,-10,10,,,40
84,30,0,5123,-20,60,80,20,1,40,40,1.5,-10,40
84,31,1,4807,-20,20,40,20,1,-20,20,0.5,-10,60
84,32,2,5117,-50,0,50,50,1,10,10,0.2,-50,40
84,33,3,3938,30,60,30,30,1,-30,30,,30,60
84,34,4,3141,40,80,40,40,1,0,0,1,50,40
84,35,5,5166,-40,40,80,40,1,40,40,1.75,-50,40
84,36,6,7004,,100,,,1,,,,,60
84,37,7,3280,10,80,70,10,1,10,10,-2,10,60
84,38,8,3369,10,20,10,10,1,-30,30,4,10,40
84,39,9,4209,-10,40,50,10,1,-10,10,0,-10,60
84,40,10,3613,50,100,50,50,1,-10,10,-0.2,50,60
84,41,11,2743,30,80,50,30,1,10,10,0,30,40
84,42,12,5570,10,60,50,10,1,10,10,-1,10,40
84,43,13,5159,20,60,40,20,1,-20,20,1,10,60
84,44,14,3729,-40,0,40,40,1,0,0,-0.5,-50,40
84,45,15,3589,-20,40,60,20,1,0,0,1,-10,60
84,46,16,3588,-40,20,60,40,1,20,20,0.5,-50,40
84,47,17,5719,40,80,40,40,1,-20,20,0.25,50,60
84,48,18,4906,-30,20,50,30,1,-10,10,-0.333333333,-30,60
84,49,19,3484,0,40,40,0,1,0,0,,,40
84,50,20,5885,-60,0,60,60,1,20,20,0.666666667,-50,40
84,51,21,3828,0,60,60,0,1,0,0,,,60
84,52,22,2896,10,80,70,10,1,10,10,2,10,60
84,53,23,6053,60,80,20,60,1,-20,20,0.5,50,40
84,54,24,3394,-50,40,90,50,1,30,30,0.8,-50,60
84,55,25,4231,10,60,50,10,1,10,10,,10,40
84,56,26,5172,50,100,50,50,1,-10,10,0.4,50,60
84,57,27,7001,,40,,,1,,,,,40
84,58,28,3547,-10,20,30,10,1,-10,10,,-10,40
84,59,29,3396,-50,20,70,50,1,10,10,,-50,60
85,0,0,3965,10,60,50,10,1,10,10,2,10,40
85,1,1,3584,0,40,40,0,1,-20,20,,,60
85,2,2,2674,-70,0,70,70,1,30,30,0,-70,40
85,3,3,4754,60,60,0,60,1,-60,60,1.333333333,50,60
85,4,4,2715,-30,40,70,30,1,30,30,0.666666667,-30,40
85,5,5,3042,-30,20,50,30,1,10,10,0.666666667,-30,40
85,6,6,2545,-60,20,80,60,1,20,20,0.166666667,-50,60
85,7,7,2778,30,100,70,30,1,10,10,-2,30,60
85,8,8,2578,50,80,30,50,1,-10,10,0,50,40
85,9,9,2691,70,80,10,70,1,-50,50,0.571428571,70,60
85,10,10,3362,30,80,50,30,1,-10,10,-0.666666667,30,60
85,11,11,2793,-10,20,30,10,1,-10,10,0,-10,40
85,12,12,3329,10,40,30,10,1,-10,10,2,10,40
85,13,13,2898,-10,20,30,10,1,-30,30,1,-10,60
85,14,14,2690,10,60,50,10,1,10,10,-3,10,40
85,15,15,2601,20,40,20,20,1,-40,40,0.5,10,60
85,16,16,3170,-20,0,20,20,1,-20,20,-1.5,-10,40
85,17,17,3386,30,60,30,30,1,-30,30,0.666666667,30,60
85,18,18,3898,50,100,50,50,1,-10,10,0,50,60
85,19,19,2713,30,80,50,30,1,10,10,0,30,40
85,20,20,2720,-30,20,50,30,1,10,10,-1,-30,40
85,21,21,3602,50,100,50,50,1,-10,10,-0.6,50,60
85,22,22,3401,0,20,20,0,1,-40,40,,,60
85,23,23,2746,-40,40,80,40,1,40,40,0.75,-50,40
85,24,24,2595,0,60,60,0,1,0,0,,,60
85,25,25,2625,-50,0,50,50,1,10,10,0,-50,40
85,26,26,3465,0,80,80,0,1,20,20,,,60
85,27,27,2649,30,80,50,30,1,10,10,0,30,40
85,28,28,2818,10,60,50,10,1,10,10,,10,40
85,29,29,3690,-40,40,80,40,1,20,20,,-50,60
85,30,0,3677,30,80,50,30,0,-10,10,0,30,60
85,31,1,2571,-20,30,50,20,0,10,10,0.5,-10,40
85,32,2,2936,0,40,40,0,0,0,0,,,40
85,33,3,2690,20,70,50,20,0,-10,10,-1.5,10,60
85,34,4,3705,30,50,20,30,0,-40,40,1,30,60
85,35,5,3761,-20,20,40,20,0,0,0,-0.5,-10,40
85,36,6,2730,10,60,50,10,0,10,10,0,10,40
85,37,7,2666,-10,40,50,10,0,-10,10,2,-10,60
85,38,8,3163,0,50,50,0,0,10,10,,,40
85,39,9,2586,30,60,30,30,0,-30,30,0.666666667,30,60
85,40,10,2898,20,60,40,20,0,0,0,0,10,40
85,41,11,2536,30,80,50,30,0,-10,10,1,30,60
85,42,12,2720,-40,40,80,40,0,20,20,0,-50,60
85,43,13,2650,-10,30,40,10,0,0,0,-1,-10,40
85,44,14,2634,-10,70,80,10,0,20,20,2,-10,60
85,45,15,3715,0,50,50,0,0,10,10,,,40
85,46,16,3280,-10,50,60,10,0,0,0,1,-10,60
85,47,17,2674,0,40,40,0,0,0,0,,,40
85,48,18,3602,10,60,50,10,0,-10,10,1,10,60
85,49,19,3602,-20,20,40,20,0,0,0,0.5,-10,40
85,50,20,2826,-20,40,60,20,0,0,0,1,-10,60
85,51,21,2721,10,50,40,10,0,-20,20,2,10,60
85,52,22,3265,30,60,30,30,0,-10,10,0.666666667,30,40
85,53,23,2450,-30,20,50,30,0,10,10,0.333333333,-30,40
85,54,24,3050,10,70,60,10,0,0,0,1,10,60
85,55,25,2914,10,50,40,10,0,0,0,0,10,40
85,56,26,3802,0,40,40,0,0,0,0,,,40
85,57,27,2584,10,80,70,10,0,10,10,-1,10,60
85,58,28,3146,0,60,60,0,0,0,0,,,60
85,59,29,3378,-10,30,40,10,0,0,0,,-10,40
86,0,0,5110,-40,20,60,40,1,20,20,-0.75,-50,40
86,1,1,3115,-20,20,40,20,1,-20,20,-2.5,-10,60
86,2,2,5368,-50,40,90,50,1,50,50,1,-50,40
86,3,3,3577,10,100,90,10,1,30,30,-2,10,60
86,4,4,4893,40,80,40,40,1,0,0,0.5,50,40
86,5,5,5695,-60,0,60,60,1,20,20,-0.5,-50,40
86,6,6,5067,-30,40,70,30,1,10,10,1.333333333,-30,60
86,7,7,4832,30,60,30,30,1,-30,30,2,30,60
86,8,8,5741,-30,60,90,30,1,50,50,0.666666667,-30,40
86,9,9,5057,-10,80,90,10,1,30,30,4,-10,60
86,10,10,4182,10,60,50,10,1,-10,10,1,10,60
86,11,11,5134,-70,0,70,70,1,30,30,0.714285714,-70,40
86,12,12,5089,20,40,20,20,1,-20,20,0,10,40
86,13,13,4463,40,100,60,40,1,0,0,0,50,60
86,14,14,5512,60,80,20,60,1,-20,20,1.166666667,50,40
86,15,15,4646,20,80,60,20,1,0,0,-1,10,60
86,16,16,3241,-30,60,90,30,1,50,50,2.333333333,-30,40
86,17,17,3393,0,40,40,0,1,-20,20,,,60
86,18,18,3793,0,20,20,0,1,-40,40,,,60
86,19,19,9259,0,20,20,0,1,-20,20,,,40
86,20,20,3677,20,80,60,20,1,20,20,1.5,10,40
86,21,21,4295,-50,20,70,50,1,10,10,0.4,-50,60
86,22,22,3737,-10,40,50,10,1,-10,10,-2,-10,60
86,23,23,3197,-30,60,90,30,1,50,50,2.333333333,-30,40
86,24,24,4439,30,100,70,30,1,10,10,0,30,60
86,25,25,3090,-20,0,20,20,1,-20,20,-2.5,-10,40
86,26,26,2980,10,80,70,10,1,10,10,0,10,60
86,27,27,4186,-50,20,70,50,1,30,30,0.2,-50,40
86,28,28,3207,-20,40,60,20,1,20,20,,-10,40
86,29,29,3292,-10,60,70,10,1,10,10,,-10,60
86,30,0,3309,20,40,20,20,0,-40,40,2,10,60
86,31,1,4250,-10,40,50,10,0,10,10,3,-10,40
86,32,2,4692,10,30,20,10,0,-20,20,6,10,40
86,33,3,3033,10,70,60,10,0,0,0,-4,10,60
86,34,4,3038,30,50,20,30,0,-40,40,1.666666667,30,60
86,35,5,5952,-30,50,80,30,0,40,40,0.666666667,-30,40
86,36,6,3873,-40,20,60,40,0,20,20,-0.25,-50,40
86,37,7,3231,-10,60,70,10,0,10,10,4,-10,60
86,38,8,3293,-10,60,70,10,0,30,30,6,-10,40
86,39,9,3442,50,80,30,50,0,-30,30,1.2,50,60
86,40,10,4380,40,50,10,40,0,-30,30,2,50,40
86,41,11,3846,-30,60,90,30,0,30,30,1.666666667,-30,60
86,42,12,3462,40,80,40,40,0,-20,20,1,50,60
86,43,13,4181,-70,20,90,70,0,50,50,0.428571429,-70,40
86,44,14,3159,-10,70,80,10,0,20,20,3,-10,60
86,45,15,3387,-30,30,60,30,0,20,20,-0.333333333,-30,40
86,46,16,3504,-10,40,50,10,0,-10,10,-4,-10,60
86,47,17,5124,-30,40,70,30,0,30,30,1.333333333,-30,40
86,48,18,3376,-40,50,90,40,0,30,30,0.75,-50,60
86,49,19,4272,30,60,30,30,0,-10,10,0.333333333,30,40
86,50,20,3881,20,80,60,20,0,0,0,0.5,10,60
86,51,21,5114,0,70,70,0,0,10,10,,,60
86,52,22,3861,-10,30,40,10,0,0,0,2,-10,40
86,53,23,4455,0,20,20,0,0,-20,20,,,40
86,54,24,3754,0,40,40,0,0,-20,20,,,60
86,55,25,6857,30,60,30,30,0,-10,10,0,30,40
86,56,26,4221,20,50,30,20,0,-10,10,-1,10,40
86,57,27,3874,10,60,50,10,0,-10,10,1,10,60
86,58,28,4384,-10,50,60,10,0,0,0,,-10,60
86,59,29,4342,30,40,10,30,0,-30,30,,30,40
87,0,0,4153,-30,50,80,30,0,20,20,0,-30,60
87,1,1,3509,-10,30,40,10,0,0,0,-4,-10,40
87,2,2,3516,-20,60,80,20,0,40,40,2,-10,40
87,3,3,3235,-40,40,80,40,0,20,20,0.25,-50,60
87,4,4,3615,-10,60,70,10,0,10,10,-1,-10,60
87,5,5,4059,-20,20,40,20,0,0,0,0,-10,40
87,6,6,3218,0,40,40,0,0,0,0,,,40
87,7,7,2945,0,80,80,0,0,20,20,,,60
87,8,8,3411,0,50,50,0,0,10,10,,,40
87,9,9,3444,-20,70,90,20,0,30,30,0,-10,60
87,10,10,3067,10,50,40,10,0,0,0,-1,10,40
87,11,11,5340,-30,60,90,30,0,30,30,0,-30,60
87,12,12,4435,-40,50,90,40,0,30,30,0,-50,60
87,13,13,3603,30,60,30,30,0,-10,10,0.333333333,30,40
87,14,14,3343,-50,40,90,50,0,30,30,0.2,-50,60
87,15,15,3855,0,40,40,0,0,0,0,,,40
87,16,16,4427,0,80,80,0,0,20,20,,,60
87,17,17,3295,0,20,20,0,0,-20,20,,,40
87,18,18,2959,0,70,70,0,0,10,10,,,60
87,19,19,3421,-20,30,50,20,0,10,10,0.5,-10,40
87,20,20,2929,-40,40,80,40,0,20,20,0,-50,60
87,21,21,3095,0,80,80,0,0,20,20,,,60
87,22,22,3051,20,60,40,20,0,0,0,0.5,10,40
87,23,23,2929,-10,40,50,10,0,10,10,3,-10,40
87,24,24,2899,0,70,70,0,0,10,10,,,60
87,25,25,3119,30,50,20,30,0,-20,20,0.666666667,30,40
87,26,26,4496,-20,20,40,20,0,0,0,0.5,-10,40
87,27,27,2960,-10,50,60,10,0,0,0,1,-10,60
87,28,28,4345,10,60,50,10,0,-10,10,,10,60
87,29,29,2743,0,30,30,0,0,-10,10,,,40
87,30,0,5016,-20,60,80,20,1,40,40,0.5,-10,40
87,31,1,3319,-10,40,50,10,1,-10,10,2,-10,60
87,32,2,3184,-70,0,70,70,1,30,30,0.571428571,-70,40
87,33,3,2872,70,100,30,70,1,-30,30,0.714285714,70,60
87,34,4,3461,10,40,30,10,1,-10,10,-1,10,40
87,35,5,2768,0,20,20,0,1,-20,20,,,40
87,36,6,3160,0,80,80,0,1,20,20,,,60
87,37,7,3057,-50,20,70,50,1,10,10,0.6,-50,60
87,38,8,2980,30,80,50,30,1,10,10,1.666666667,30,40
87,39,9,3435,20,60,40,20,1,-20,20,-1,10,60
87,40,10,4713,80,100,20,80,1,-40,40,0.75,70,60
87,41,11,4763,-20,80,100,20,1,60,60,0,-10,40
87,42,12,3963,-60,40,100,60,1,60,60,1.333333333,-50,40
87,43,13,3400,0,80,80,0,1,20,20,,,60
87,44,14,3659,40,60,20,40,1,-20,20,1.25,50,40
87,45,15,2763,-60,20,80,60,1,20,20,0.666666667,-50,60
87,46,16,3108,-50,20,70,50,1,30,30,0.4,-50,40
87,47,17,2991,0,40,40,0,1,-20,20,,,60
87,48,18,3246,0,60,60,0,1,0,0,,,60
87,49,19,3283,-50,0,50,50,1,10,10,-0.6,-50,40
87,50,20,5332,-40,40,80,40,1,40,40,0.75,-50,40
87,51,21,4033,-60,20,80,60,1,20,20,0.666666667,-50,60
87,52,22,3111,0,40,40,0,1,-20,20,,,60
87,53,23,2897,-50,0,50,50,1,10,10,0.4,-50,40
87,54,24,3374,-20,80,100,20,1,40,40,0,-10,60
87,55,25,3415,-10,20,30,10,1,-10,10,1,-10,40
87,56,26,3553,0,100,100,0,1,40,40,,,60
87,57,27,4107,40,60,20,40,1,-20,20,0.5,50,40
87,58,28,3675,40,80,40,40,1,0,0,,50,40
87,59,29,4944,30,60,30,30,1,-30,30,,30,60
88,0,0,4677,-40,0,40,40,1,0,0,0.5,-50,40
88,1,1,3734,20,40,20,20,1,-40,40,1,10,60
88,2,2,3486,60,80,20,60,1,-20,20,0.5,50,40
88,3,3,3652,60,100,40,60,1,-20,20,0.5,50,60
88,4,4,3721,-10,40,50,10,1,10,10,0,-10,40
88,5,5,3381,10,60,50,10,1,10,10,-2,10,40
88,6,6,3404,-50,20,70,50,1,10,10,0,-50,60
88,7,7,3637,10,80,70,10,1,10,10,1,10,60
88,8,8,3521,-10,20,30,10,1,-10,10,-4,-10,40
88,9,9,3421,-20,60,80,20,1,20,20,-0.5,-10,60
88,10,10,3368,-70,20,90,70,1,30,30,0.142857143,-70,60
88,11,11,2906,-50,20,70,50,1,30,30,-0.4,-50,40
88,12,12,3231,-30,60,90,30,1,50,50,0.333333333,-30,40
88,13,13,2879,20,100,80,20,1,20,20,-0.5,10,60
88,14,14,3358,0,80,80,0,1,40,40,,,40
88,15,15,2978,-10,60,70,10,1,10,10,2,-10,60
88,16,16,3071,-80,0,80,80,1,40,40,0.125,-70,40
88,17,17,2912,-10,40,50,10,1,-10,10,-4,-10,60
88,18,18,3688,-10,80,90,10,1,30,30,0,-10,60
88,19,19,2850,-30,40,70,30,1,30,30,1.666666667,-30,40
88,20,20,2949,40,60,20,40,1,-20,20,0.5,50,40
88,21,21,3258,-70,20,90,70,1,30,30,0.285714286,-70,60
88,22,22,2962,30,100,70,30,1,10,10,1,30,60
88,23,23,3489,40,80,40,40,1,0,0,0.75,50,40
88,24,24,3354,-40,60,100,40,1,40,40,0.75,-50,60
88,25,25,2916,-30,40,70,30,1,30,30,-0.666666667,-30,40
88,26,26,3131,-30,40,70,30,1,10,10,-0.666666667,-30,60
88,27,27,3954,-70,20,90,70,1,50,50,0.285714286,-70,40
88,28,28,3333,-70,0,70,70,1,30,30,,-70,40
88,29,29,2978,-10,80,90,10,1,30,30,,-10,60
88,30,0,3736,10,40,30,10,0,-30,30,4,10,60
88,31,1,2981,-50,20,70,50,0,30,30,-0.4,-50,40
88,32,2,3397,-50,40,90,50,0,50,50,0.8,-50,40
88,33,3,3148,0,70,70,0,0,10,10,,,60
88,34,4,3370,0,60,60,0,0,0,0,,,60
88,35,5,3071,-20,30,50,20,0,10,10,-2,-10,40
88,36,6,2988,-30,60,90,30,0,50,50,0.666666667,-30,40
88,37,7,3257,40,80,40,40,0,-20,20,-0.5,50,60
88,38,8,3574,-20,50,70,20,0,30,30,1,-10,40
88,39,9,2860,30,50,20,30,0,-40,40,1.666666667,30,60
88,40,10,2854,-10,40,50,10,0,10,10,2,-10,40
88,41,11,3037,0,70,70,0,0,10,10,,,60
88,42,12,3325,-20,80,100,20,0,40,40,1,-10,60
88,43,13,2996,0,30,30,0,0,-10,10,,,40
88,44,14,4652,-30,50,80,30,0,20,20,-0.333333333,-30,60
88,45,15,3159,30,60,30,30,0,-10,10,0,30,40
88,46,16,2882,-30,60,90,30,0,30,30,0.333333333,-30,60
88,47,17,2827,20,50,30,20,0,-10,10,0,10,40
88,48,18,3785,-40,40,80,40,0,20,20,-0.25,-50,60
88,49,19,4113,-10,20,30,10,0,-10,10,1,-10,40
88,50,20,2892,-20,70,90,20,0,30,30,3,-10,60
88,51,21,3752,30,60,30,30,0,-30,30,1,30,60
88,52,22,3062,20,40,20,20,0,-20,20,3,10,40
88,53,23,2964,-20,60,80,20,0,40,40,0.5,-10,40
88,54,24,3788,20,80,60,20,0,0,0,0,10,60
88,55,25,2873,-50,20,70,50,0,30,30,0.8,-50,40
88,56,26,3533,0,30,30,0,0,-10,10,,,40
88,57,27,3682,-20,40,60,20,0,0,0,1.5,-10,60
88,58,28,3920,20,50,30,20,0,-30,30,,10,60
88,59,29,2987,-20,50,70,20,0,30,30,,-10,40
89,0,0,4779,0,70,70,0,0,10,10,,,60
89,1,1,7001,,50,,,0,,,,,40
89,2,2,5404,-50,20,70,50,0,30,30,0.2,-50,40
89,3,3,3259,0,50,50,0,0,-10,10,,,60
89,4,4,2720,-30,40,70,30,0,10,10,-0.333333333,-30,60
89,5,5,3135,0,60,60,0,0,20,20,,,40
89,6,6,3445,-30,30,60,30,0,20,20,-0.333333333,-30,40
89,7,7,2840,-20,60,80,20,0,20,20,1.65,-10,60
89,8,8,4526,-30,40,70,30,0,30,30,0.666666667,-30,40
89,9,9,3875,33,80,47,33,0,-13,13,-0.212121212,30,60
89,10,10,2955,-10,40,50,10,0,10,10,1.4,-10,40
89,11,11,4210,30,70,40,30,0,-20,20,0.966666667,30,60
89,12,12,7001,-19,50,69,19,0,9,9,0,-10,60
89,13,13,3348,14,50,36,14,0,-4,4,2.428571429,10,40
89,14,14,4173,-29,40,69,29,0,9,9,,-30,60
89,15,15,4570,-50,20,70,50,0,30,30,,-50,40
89,16,16,6050,,60,,,0,,,,,60
89,17,17,7001,,60,,,0,,,,,40
89,18,18,3671,20,80,60,20,0,0,0,0.5,10,60
89,19,19,3501,-40,30,70,40,0,30,30,0.5,-50,40
89,20,20,3526,0,70,70,0,0,10,10,,,60
89,21,21,3550,-20,40,60,20,0,0,0,0,-10,60
89,22,22,3182,0,50,50,0,0,10,10,,,40
89,23,23,4038,0,60,60,0,0,20,20,,,40
89,24,24,4469,-10,50,60,10,0,0,0,2,-10,60
89,25,25,3461,-20,40,60,20,0,20,20,-1,-10,40
89,26,26,4155,-50,30,80,50,0,40,40,0.2,-50,40
89,27,27,3329,40,80,40,40,0,-20,20,0.75,50,60
89,28,28,3920,-10,60,70,10,0,10,10,,-10,60
89,29,29,3626,-50,20,70,50,0,30,30,,-50,40
89,30,0,3004,-19,40,59,19,1,19,19,1.526315789,-10,40
89,31,1,4123,0,60,60,0,1,0,0,,,60
89,32,2,3328,-10,20,30,10,1,-10,10,0,-10,40
89,33,3,3943,-30,40,70,30,1,10,10,0,-30,60
89,34,4,3742,30,60,30,30,1,-10,10,1.333333333,30,40
89,35,5,4259,10,80,70,10,1,30,30,-2,10,40
89,36,6,3564,10,80,70,10,1,10,10,0,10,60
89,37,7,4685,-50,20,70,50,1,10,10,-0.38,-50,60
89,38,8,5009,-50,0,50,50,1,10,10,-0.6,-50,40
89,39,9,2915,11,100,89,11,1,29,29,-0.818181818,10,60
89,40,10,3269,-60,20,80,60,1,20,20,0.666666667,-50,60
89,41,11,3562,-80,0,80,80,1,40,40,0.625,-70,40
89,42,12,4367,10,40,30,10,1,-10,10,5,10,40
89,43,13,3655,40,80,40,40,1,-20,20,0.75,50,60
89,44,14,3779,-20,60,80,20,1,40,40,1,-10,40
89,45,15,6492,30,100,70,30,1,10,10,-1,30,60
89,46,16,7002,20,80,60,20,1,20,20,0,10,40
89,47,17,4528,20,60,40,20,1,-20,20,2,10,60
89,48,18,3649,-40,40,80,40,1,20,20,1.875,-50,60
89,49,19,3177,-40,20,60,40,1,20,20,-0.25,-50,40
89,50,20,3413,-10,60,70,10,1,30,30,-1,-10,40
89,51,21,7002,35,40,5,35,1,-55,55,1.285714286,30,60
89,52,22,3374,10,60,50,10,1,-10,10,-1,10,60
89,53,23,4081,0,80,80,0,1,40,40,,,40
89,54,24,3157,-20,20,40,20,1,-20,20,,-10,60
89,55,25,7002,,20,,,1,,,,,40
89,56,26,7002,,100,,,1,,,,,60
89,57,27,3031,-30,40,70,30,1,30,30,,-30,40
89,58,28,7002,,0,,,1,,,,,40
89,59,29,3039,30,80,50,30,1,-10,10,,30,60
90,0,0,3910,10,60,50,10,1,10,10,2,10,40
90,1,1,3134,20,40,20,20,1,-40,40,0,10,60
90,2,2,3777,-30,40,70,30,1,30,30,-1,-30,40
90,3,3,3976,80,100,20,80,1,-40,40,0.125,70,60
90,4,4,3288,-20,80,100,20,1,60,60,2.5,-10,40
90,5,5,4217,-30,20,50,30,1,10,10,-0.333333333,-30,40
90,6,6,3379,30,60,30,30,1,-30,30,1.666666667,30,60
90,7,7,3737,-60,20,80,60,1,20,20,0.833333333,-50,60
90,8,8,3578,-60,0,60,60,1,20,20,0.333333333,-50,40
90,9,9,3953,50,80,30,50,1,-30,30,1.4,50,60
90,10,10,3630,-60,40,100,60,1,40,40,1,-50,60
90,11,11,4395,40,80,40,40,1,0,0,0.5,50,40
90,12,12,3049,-20,40,60,20,1,20,20,2,-10,40
90,13,13,5155,60,100,40,60,1,-20,20,0,50,60
90,14,14,2976,40,60,20,40,1,-20,20,1,50,40
90,15,15,4625,-20,20,40,20,1,-20,20,0.5,-10,60
90,16,16,4273,-60,0,60,60,1,20,20,0,-50,40
90,17,17,3346,30,60,30,30,1,-30,30,0.666666667,30,60
90,18,18,3169,30,80,50,30,1,-10,10,1,30,60
90,19,19,4850,-40,20,60,40,1,20,20,0.5,-50,40
90,20,20,3482,20,60,40,20,1,0,0,0,10,40
90,21,21,3008,-60,20,80,60,1,20,20,0.333333333,-50,60
90,22,22,4367,40,100,60,40,1,0,0,-0.25,50,60
90,23,23,3012,0,40,40,0,1,0,0,,,40
90,24,24,4927,10,60,50,10,1,-10,10,2,10,60
90,25,25,3809,60,80,20,60,1,-20,20,0.333333333,50,40
90,26,26,3856,10,80,70,10,1,10,10,1,10,60
90,27,27,3826,-40,0,40,40,1,0,0,-0.25,-50,40
90,28,28,3286,-30,20,50,30,1,10,10,,-30,40
90,29,29,3250,-40,40,80,40,1,20,20,,-50,60
90,30,0,4141,-30,70,100,30,0,40,40,1.333333333,-30,60
90,31,1,4241,0,20,20,0,0,-20,20,,,40
90,32,2,4129,40,60,20,40,0,-20,20,0.5,50,40
90,33,3,3226,20,80,60,20,0,0,0,-0.5,10,60
90,34,4,3896,-10,40,50,10,0,-10,10,2,-10,60
90,35,5,3394,10,50,40,10,0,0,0,1,10,40
90,36,6,7457,-10,40,50,10,0,10,10,-1,-10,40
90,37,7,4337,20,50,30,20,0,-30,30,0,10,60
90,38,8,5092,-30,30,60,30,0,20,20,0.333333333,-30,40
90,39,9,6198,30,60,30,30,0,-30,30,1,30,60
90,40,10,6702,-20,30,50,20,0,10,10,1,-10,40
90,41,11,4585,10,70,60,10,0,0,0,1,10,60
90,42,12,5734,-10,60,70,10,0,10,10,3,-10,60
90,43,13,3224,30,60,30,30,0,-10,10,0,30,40
90,44,14,3396,0,40,40,0,0,-20,20,,,60
90,45,15,4121,20,50,30,20,0,-10,10,1.5,10,40
90,46,16,6697,40,80,40,40,0,-20,20,0.25,50,60
90,47,17,4138,-20,40,60,20,0,20,20,2,-10,40
90,48,18,6087,0,50,50,0,0,-10,10,,,60
90,49,19,5595,0,20,20,0,0,-20,20,,,40
90,50,20,4437,-10,40,50,10,0,-10,10,-1,-10,60
90,51,21,3888,10,70,60,10,0,0,0,-4,10,60
90,52,22,3964,20,50,30,20,0,-10,10,1.5,10,40
90,53,23,4208,-40,20,60,40,0,20,20,0.5,-50,40
90,54,24,5128,30,50,20,30,0,-40,40,1,30,60
90,55,25,6238,-10,30,40,10,0,0,0,1,-10,40
90,56,26,3960,30,60,30,30,0,-10,10,0.666666667,30,40
90,57,27,4068,10,60,50,10,0,-10,10,-1,10,60
90,58,28,4522,40,80,40,40,0,-20,20,,50,60
90,59,29,5113,-10,40,50,10,0,10,10,,-10,40
91,0,0,4056,20,70,50,20,0,-10,10,0,10,60
91,1,1,3981,0,50,50,0,0,10,10,,,40
91,2,2,3825,0,30,30,0,0,-10,10,,,40
91,3,3,3535,30,80,50,30,0,-10,10,0.333333333,30,60
91,4,4,3873,0,60,60,0,0,0,0,,,60
91,5,5,3842,0,20,20,0,0,-20,20,,,40
91,6,6,5145,-10,40,50,10,0,10,10,-3,-10,40
91,7,7,3505,-10,50,60,10,0,0,0,1,-10,60
91,8,8,3721,-20,60,80,20,0,40,40,1,-10,40
91,9,9,3977,-10,40,50,10,0,-10,10,-3,-10,60
91,10,10,4265,-40,20,60,40,0,20,20,1,-50,40
91,11,11,3778,0,80,80,0,0,20,20,,,60
91,12,12,4871,10,70,60,10,0,0,0,2,10,60
91,13,13,4296,10,30,20,10,0,-20,20,2,10,40
91,14,14,6146,-20,60,80,20,0,20,20,0,-10,60
91,15,15,4537,0,40,40,0,0,0,0,,,40
91,16,16,4225,-30,50,80,30,0,20,20,0.666666667,-30,60
91,17,17,3840,10,50,40,10,0,0,0,0,10,40
91,18,18,4448,-20,40,60,20,0,0,0,-1,-10,60
91,19,19,3679,20,60,40,20,0,0,0,-0.5,10,40
91,20,20,3552,-20,60,80,20,0,20,20,1,-10,60
91,21,21,4521,20,80,60,20,0,0,0,1,10,60
91,22,22,4864,-10,20,30,10,0,-10,10,-2,-10,40
91,23,23,3664,-20,30,50,20,0,10,10,0.5,-10,40
91,24,24,3815,-30,50,80,30,0,20,20,0.666666667,-30,60
91,25,25,3714,20,60,40,20,0,0,0,0,10,40
91,26,26,5089,0,40,40,0,0,0,0,,,40
91,27,27,3970,-20,40,60,20,0,0,0,0.5,-10,60
91,28,28,3872,20,70,50,20,0,-10,10,,10,60
91,29,29,4553,-20,50,70,20,0,30,30,,-10,40
91,30,0,3464,-30,20,50,30,1,10,10,0.666666667,-30,40
91,31,1,3386,0,60,60,0,1,0,0,,,60
91,32,2,4183,-30,0,30,30,1,-10,10,-1,-30,40
91,33,3,3841,-20,40,60,20,1,0,0,1,-10,60
91,34,4,4880,20,80,60,20,1,20,20,0,10,40
91,35,5,5201,-20,40,60,20,1,20,20,1.5,-10,40
91,36,6,5544,-20,20,40,20,1,-20,20,-1,-10,60
91,37,7,5425,40,100,60,40,1,0,0,-0.75,50,60
91,38,8,4992,30,60,30,30,1,-10,10,1.666666667,30,40
91,39,9,4562,50,80,30,50,1,-30,30,-0.2,50,60
91,40,10,5608,60,80,20,60,1,-40,40,1.166666667,50,60
91,41,11,5241,-60,20,80,60,1,40,40,1.166666667,-50,40
91,42,12,4505,-10,0,10,10,1,-30,30,-2,-10,40
91,43,13,4521,-50,40,90,50,1,30,30,1.2,-50,60
91,44,14,4135,10,40,30,10,1,-10,10,3,10,40
91,45,15,4640,-10,20,30,10,1,-30,30,-1,-10,60
91,46,16,5119,0,60,60,0,1,20,20,,,40
91,47,17,4248,60,100,40,60,1,-20,20,0.166666667,50,60
91,48,18,4794,10,60,50,10,1,-10,10,0,10,60
91,49,19,4904,20,80,60,20,1,20,20,0,10,40
91,50,20,5433,-40,20,60,40,1,20,20,0.75,-50,40
91,51,21,4903,50,100,50,50,1,-10,10,-0.2,50,60
91,52,22,4329,40,80,40,40,1,-20,20,1,50,60
91,53,23,5024,10,40,30,10,1,-10,10,3,10,40
91,54,24,4336,-20,60,80,20,1,20,20,2.5,-10,60
91,55,25,6104,0,60,60,0,1,20,20,,,40
91,56,26,4057,-10,20,30,10,1,-30,30,-4,-10,60
91,57,27,3808,-80,0,80,80,1,40,40,0,-70,40
91,58,28,4201,0,80,80,0,1,40,40,,,40
91,59,29,3921,-30,40,70,30,1,10,10,,-30,60
92,0,0,3446,-50,0,50,50,1,10,10,0.6,-50,40
92,1,1,3228,30,80,50,30,1,-10,10,0.333333333,30,60
92,2,2,3897,40,60,20,40,1,-20,20,0.75,50,40
92,3,3,4232,40,100,60,40,1,0,0,0.75,50,60
92,4,4,3257,-30,20,50,30,1,10,10,0,-30,40
92,5,5,3078,30,80,50,30,1,10,10,-1,30,40
92,6,6,2942,-70,20,90,70,1,30,30,0.571428571,-70,60
92,7,7,2763,10,60,50,10,1,-10,10,2,10,60
92,8,8,3453,20,40,20,20,1,-20,20,2,10,40
92,9,9,3558,-30,40,70,30,1,10,10,0.666666667,-30,60
92,10,10,3125,50,100,50,50,1,-10,10,0.6,50,60
92,11,11,3128,-20,40,60,20,1,20,20,-2,-10,40
92,12,12,4138,-100,0,100,100,1,60,60,0.5,-70,40
92,13,13,3183,-40,40,80,40,1,20,20,0,-50,60
92,14,14,3419,-30,20,50,30,1,10,10,0.333333333,-30,40
92,15,15,3041,-60,20,80,60,1,20,20,0.166666667,-50,60
92,16,16,3230,40,80,40,40,1,0,0,-0.5,50,40
92,17,17,3371,10,80,70,10,1,10,10,-2,10,60
92,18,18,4012,10,60,50,10,1,-10,10,3,10,60
92,19,19,3925,40,60,20,40,1,-20,20,1,50,40
92,20,20,3621,0,60,60,0,1,20,20,,,40
92,21,21,2961,-60,20,80,60,1,20,20,0.166666667,-50,60
92,22,22,3013,10,80,70,10,1,10,10,-2,10,60
92,23,23,2885,0,40,40,0,1,0,0,,,40
92,24,24,3164,-10,40,50,10,1,-10,10,-2,-10,60
92,25,25,3200,-60,0,60,60,1,20,20,0.333333333,-50,40
92,26,26,2970,30,100,70,30,1,10,10,0.666666667,30,60
92,27,27,3373,-20,20,40,20,1,0,0,-1,-10,40
92,28,28,3130,20,80,60,20,1,20,20,,10,40
92,29,29,2981,-30,60,90,30,1,30,30,,-30,60
92,30,0,3666,-10,40,50,10,0,-10,10,-5,-10,60
92,31,1,6711,,60,,,0,,,,,40
92,32,2,3466,-10,50,60,10,0,20,20,2,-10,40
92,33,3,3233,-30,70,100,30,0,40,40,0.666666667,-30,60
92,34,4,3134,-30,50,80,30,0,20,20,0.333333333,-30,60
92,35,5,2784,0,40,40,0,0,0,0,,,40
92,36,6,2923,-40,20,60,40,0,20,20,0.25,-50,40
92,37,7,3112,10,80,70,10,0,10,10,0,10,60
92,38,8,3519,-20,30,50,20,0,10,10,0,-10,40
92,39,9,3081,-10,60,70,10,0,10,10,1,-10,60
92,40,10,3409,-20,30,50,20,0,10,10,0,-10,40
92,41,11,3761,-20,40,60,20,0,0,0,-1,-10,60
92,42,12,3086,-20,60,80,20,0,20,20,1,-10,60
92,43,13,3751,-10,40,50,10,0,10,10,1,-10,40
92,44,14,3889,10,70,60,10,0,0,0,0,10,60
92,45,15,2947,20,60,40,20,0,0,0,-1,10,40
92,46,16,3050,-10,50,60,10,0,0,0,-1,-10,60
92,47,17,3909,0,20,20,0,0,-20,20,,,40
92,48,18,3048,10,80,70,10,0,10,10,1,10,60
92,49,19,3030,30,50,20,30,0,-20,20,1.333333333,30,40
92,50,20,3473,-40,40,80,40,0,20,20,1,-50,60
92,51,21,3064,20,60,40,20,0,-20,20,1.5,10,60
92,52,22,3119,-20,40,60,20,0,20,20,2,-10,40
92,53,23,3674,10,30,20,10,0,-20,20,3,10,40
92,54,24,2946,-20,50,70,20,0,10,10,-1,-10,60
92,55,25,2854,0,50,50,0,0,10,10,,,40
92,56,26,3149,-20,20,40,20,0,0,0,-0.5,-10,40
92,57,27,2929,-20,70,90,20,0,30,30,0,-10,60
92,58,28,3612,-10,80,90,10,0,30,30,,-10,60
92,59,29,3043,10,60,50,10,0,10,10,,10,40
93,0,0,4794,-30,0,30,30,1,-10,10,0.333333333,-30,40
93,1,1,5672,30,60,30,30,1,-30,30,0,30,60
93,2,2,3722,60,80,20,60,1,-20,20,0.666666667,50,40
93,3,3,4114,-10,20,30,10,1,-30,30,1,-10,60
93,4,4,3698,0,60,60,0,1,20,20,,,40
93,5,5,3365,-30,40,70,30,1,30,30,1.666666667,-30,40
93,6,6,3193,60,80,20,60,1,-40,40,0.166666667,50,60
93,7,7,3339,70,100,30,70,1,-30,30,0.714285714,70,60
93,8,8,2793,0,20,20,0,1,-20,20,,,40
93,9,9,4329,-40,40,80,40,1,20,20,0,-50,60
93,10,10,4762,-20,60,80,20,1,20,20,0.5,-10,60
93,11,11,4075,-30,0,30,30,1,-10,10,0.666666667,-30,40
93,12,12,3520,10,20,10,10,1,-30,30,1,10,40
93,13,13,4210,30,100,70,30,1,10,10,0.333333333,30,60
93,14,14,3785,40,60,20,40,1,-20,20,0.5,50,40
93,15,15,4331,0,80,80,0,1,20,20,,,60
93,16,16,3538,0,40,40,0,1,0,0,,,40
93,17,17,2771,-70,20,90,70,1,30,30,0,-70,60
93,18,18,3842,-50,40,90,50,1,30,30,1,-50,60
93,19,19,3346,70,80,10,70,1,-30,30,0,70,40
93,20,20,5259,10,20,10,10,1,-30,30,4,10,40
93,21,21,2857,20,60,40,20,1,-20,20,2,10,60
93,22,22,3809,20,100,80,20,1,20,20,-0.5,10,60
93,23,23,3975,-10,40,50,10,1,10,10,5,-10,40
93,24,24,4754,-50,20,70,50,1,10,10,0.4,-50,60
93,25,25,3258,0,0,0,0,1,-40,40,,,40
93,26,26,4315,30,80,50,30,1,-10,10,-1.333333333,30,60
93,27,27,4235,20,60,40,20,1,0,0,0,10,40
93,28,28,3922,40,80,40,40,1,0,0,,50,40
93,29,29,3883,30,40,10,30,1,-50,50,,30,60
93,30,0,5095,40,40,0,40,0,-60,60,2.25,50,60
93,31,1,3482,30,40,10,30,0,-30,30,2.333333333,30,40
93,32,2,2408,-50,30,80,50,0,40,40,1.4,-50,40
93,33,3,3707,-20,70,90,20,0,30,30,2.5,-10,60
93,34,4,4298,10,50,40,10,0,-20,20,4,10,60
93,35,5,3378,50,60,10,50,0,-30,30,1.4,50,40
93,36,6,3642,-60,20,80,60,0,40,40,1,-50,40
93,37,7,2755,-20,60,80,20,0,20,20,3.5,-10,60
93,38,8,2865,30,50,20,30,0,-20,20,2.333333333,30,40
93,39,9,2562,70,80,10,70,0,-50,50,1.142857143,70,60
93,40,10,2987,-60,30,90,60,0,50,50,1.166666667,-50,40
93,41,11,3883,-50,40,90,50,0,30,30,0,-50,60
93,42,12,3169,-30,60,90,30,0,30,30,0.333333333,-30,60
93,43,13,3547,20,40,20,20,0,-20,20,0,10,40
93,44,14,3441,0,80,80,0,0,20,20,,,60
93,45,15,2706,30,50,20,30,0,-20,20,2.333333333,30,40
93,46,16,3275,40,50,10,40,0,-50,50,0.25,50,60
93,47,17,2538,-30,60,90,30,0,50,50,0,-30,40
93,48,18,3098,50,70,20,50,0,-40,40,1.2,50,60
93,49,19,3529,-70,20,90,70,0,50,50,1.142857143,-70,40
93,50,20,6178,-40,40,80,40,0,20,20,1,-50,60
93,51,21,3089,10,50,40,10,0,-20,20,4,10,60
93,52,22,2738,20,30,10,20,0,-30,30,1.5,10,40
93,53,23,3266,10,50,40,10,0,0,0,-2,10,40
93,54,24,3808,-10,70,80,10,0,20,20,6,-10,60
93,55,25,4130,40,60,20,40,0,-20,20,1,50,40
93,56,26,3577,-20,40,60,20,0,20,20,0.5,-10,40
93,57,27,4239,40,60,20,40,0,-40,40,1.75,50,60
93,58,28,2633,-10,80,90,10,0,30,30,,-10,60
93,59,29,3618,-30,20,50,30,0,10,10,,-30,40
94,0,0,4591,-49,40,89,49,0,29,29,1,-50,60
94,1,1,4164,-39,40,79,39,0,39,39,0.256410256,-30,40
94,2,2,4202,-19,50,69,19,0,29,29,0.526315789,-10,40
94,3,3,4922,30,70,40,30,0,-20,20,0.666666667,30,60
94,4,4,4762,20,80,60,20,0,0,0,0.45,10,60
94,5,5,4456,-29,30,59,29,0,19,19,0.689655172,-30,40
94,6,6,4589,-19,20,39,19,0,-1,1,0.473684211,-10,40
94,7,7,4408,-19,50,69,19,0,9,9,1,-10,60
94,8,8,4776,30,60,30,30,0,-10,10,0,30,40
94,9,9,4991,10,60,50,10,0,-10,10,0,10,60
94,10,10,4452,-10,20,30,10,0,-10,10,-1,-10,40
94,11,11,4987,0,50,50,0,0,-10,10,,,60
94,12,12,4903,10,70,60,10,0,0,0,0,10,60
94,13,13,5155,20,60,40,20,0,0,0,0,10,40
94,14,14,4620,20,80,60,20,0,0,0,0.45,10,60
94,15,15,4785,10,50,40,10,0,0,0,0,10,40
94,16,16,4768,-9,60,69,9,0,9,9,1,-10,60
94,17,17,4672,0,40,40,0,0,0,0,,,40
94,18,18,4889,-20,40,60,20,0,0,0,-0.5,-10,60
94,19,19,5586,-20,30,50,20,0,10,10,1,-10,40
94,20,20,5045,-10,60,70,10,0,10,10,1,-10,60
94,21,21,5080,20,80,60,20,0,0,0,0.25,10,60
94,22,22,4569,10,40,30,10,0,-10,10,0,10,40
94,23,23,4502,0,30,30,0,0,-10,10,,,40
94,24,24,5100,-15,50,65,15,0,5,5,1.666666667,-10,60
94,25,25,4430,20,50,30,20,0,-10,10,0.3,10,40
94,26,26,4973,-16,20,36,16,0,-4,4,-0.25,-10,40
94,27,27,4437,0,40,40,0,0,-20,20,,,60
94,28,28,5461,10,70,60,10,0,0,0,,10,60
94,29,29,4232,20,60,40,20,0,0,0,,10,40
94,30,0,4662,-50,0,50,50,1,10,10,0.96,-50,40
94,31,1,5403,50,100,50,50,1,-10,10,-0.2,50,60
94,32,2,5104,78,80,2,78,1,-38,38,0.871794872,70,40
94,33,3,4495,-20,20,40,20,1,-20,20,-0.95,-10,60
94,34,4,4008,-30,40,70,30,1,30,30,0.333333333,-30,40
94,35,5,4068,-40,20,60,40,1,20,20,0.025,-50,40
94,36,6,4132,21,80,59,21,1,-1,1,0.952380952,30,60
94,37,7,4421,-39,40,79,39,1,19,19,1,-30,60
94,38,8,4072,1,60,59,1,1,19,19,-29,10,40
94,39,9,4490,20,60,40,20,1,-20,20,0.5,10,60
94,40,10,4305,50,100,50,50,1,-10,10,0,50,60
94,41,11,4654,10,40,30,10,1,-10,10,1,10,40
94,42,12,4803,20,60,40,20,1,0,0,0.5,10,40
94,43,13,4694,10,60,50,10,1,-10,10,2,10,60
94,44,14,5409,-50,0,50,50,1,10,10,0.02,-50,40
94,45,15,3993,-30,40,70,30,1,10,10,0.333333333,-30,60
94,46,16,4364,-29,20,49,29,1,9,9,0.310344828,-30,40
94,47,17,5255,20,80,60,20,1,0,0,0,10,60
94,48,18,4946,-40,20,60,40,1,0,0,0.25,-50,60
94,49,19,4565,40,80,40,40,1,0,0,0,50,40
94,50,20,4792,20,60,40,20,1,0,0,-1,10,40
94,51,21,5814,-10,40,50,10,1,-10,10,-2,-10,60
94,52,22,4683,30,100,70,30,1,10,10,0.3,30,60
94,53,23,4689,-20,0,20,20,1,-20,20,-1,-10,40
94,54,24,4181,-19,60,79,19,1,19,19,2.052631579,-10,60
94,55,25,5939,-20,20,40,20,1,0,0,0,-10,40
94,56,26,4868,40,80,40,40,1,-20,20,0.75,50,60
94,57,27,5182,0,40,40,0,1,0,0,,,40
94,58,28,4690,30,80,50,30,1,10,10,,30,40
94,59,29,5313,-50,20,70,50,1,10,10,,-50,60
95,0,0,6095,-20,60,80,20,0,20,20,0.5,-10,60
95,1,1,5902,0,40,40,0,0,0,0,,,40
95,2,2,4122,-20,30,50,20,0,10,10,1.5,-10,40
95,3,3,3839,0,70,70,0,0,10,10,,,60
95,4,4,3626,-10,50,60,10,0,0,0,-2,-10,60
95,5,5,3901,0,20,20,0,0,-20,20,,,40
95,6,6,4139,10,50,40,10,0,0,0,1,10,40
95,7,7,4151,-40,40,80,40,0,20,20,0.75,-50,60
95,8,8,4252,10,60,50,10,0,10,10,0,10,40
95,9,9,3788,30,80,50,30,0,-10,10,0.666666667,30,60
95,10,10,3722,-30,20,50,30,0,10,10,1,-30,40
95,11,11,3670,-20,50,70,20,0,10,10,0,-10,60
95,12,12,4054,10,80,70,10,0,10,10,-1,10,60
95,13,13,4351,20,40,20,20,0,-20,20,1.5,10,40
95,14,14,3919,-20,40,60,20,0,0,0,-0.5,-10,60
95,15,15,3535,-20,30,50,20,0,10,10,1.5,-10,40
95,16,16,3468,0,70,70,0,0,10,10,,,60
95,17,17,4034,40,60,20,40,0,-20,20,0.5,50,40
95,18,18,3841,0,60,60,0,0,0,0,,,60
95,19,19,3766,10,50,40,10,0,0,0,-1.1,10,40
95,20,20,3460,-10,80,90,10,0,30,30,2,-10,60
95,21,21,3959,0,70,70,0,0,10,10,,,60
95,22,22,4422,21,50,29,21,0,-11,11,0.523809524,30,40
95,23,23,3814,0,40,40,0,0,0,0,,,40
95,24,24,4410,-20,40,60,20,0,0,0,0,-10,60
95,25,25,4429,0,20,20,0,0,-20,20,,,40
95,26,26,3602,20,60,40,20,0,0,0,0.5,10,40
95,27,27,4025,-10,50,60,10,0,0,0,-1,-10,60
95,28,28,3994,-10,60,70,10,0,10,10,,-10,60
95,29,29,3939,-20,30,50,20,0,10,10,,-10,40
95,30,0,5236,-50,20,70,50,1,30,30,0.4,-50,40
95,31,1,4761,-20,40,60,20,1,0,0,0.5,-10,60
95,32,2,3980,30,80,50,30,1,10,10,-0.333333333,30,40
95,33,3,4649,50,100,50,50,1,-10,10,0.2,50,60
95,34,4,3941,0,40,40,0,1,0,0,,,40
95,35,5,3618,10,60,50,10,1,10,10,-1,10,40
95,36,6,3512,20,80,60,20,1,0,0,0.5,10,60
95,37,7,3384,-10,60,70,10,1,10,10,-1,-10,60
95,38,8,4331,-40,0,40,40,1,0,0,-0.5,-50,40
95,39,9,3854,-60,20,80,60,1,20,20,0.166666667,-50,60
95,40,10,3879,-10,60,70,10,1,10,10,-1,-10,60
95,41,11,4104,0,60,60,0,1,20,20,,,40
95,42,12,4103,-40,40,80,40,1,40,40,1.5,-50,40
95,43,13,3582,20,100,80,20,1,20,20,-2,10,60
95,44,14,4557,-20,0,20,20,1,-20,20,-1.5,-10,40
95,45,15,4315,40,80,40,40,1,-20,20,1,50,60
95,46,16,4212,30,80,50,30,1,10,10,0,30,40
95,47,17,3867,-60,20,80,60,1,20,20,0,-50,60
95,48,18,4340,-40,40,80,40,1,20,20,0.25,-50,60
95,49,19,3804,-30,20,50,30,1,10,10,0,-30,40
95,50,20,4035,30,80,50,30,1,10,10,0.666666667,30,40
95,51,21,3629,30,100,70,30,1,10,10,0,30,60
95,52,22,4659,-10,60,70,10,1,10,10,0,-10,60
95,53,23,3464,-70,0,70,70,1,30,30,0.285714286,-70,40
95,54,24,3634,-50,20,70,50,1,10,10,0.6,-50,60
95,55,25,3446,10,60,50,10,1,10,10,0,10,40
95,56,26,3653,40,80,40,40,1,-20,20,0.5,50,60
95,57,27,3608,-30,20,50,30,1,10,10,0.2,-30,40
95,58,28,4086,-4,40,44,4,1,4,4,,-10,40
95,59,29,3288,-20,40,60,20,1,0,0,,-10,60
96,0,0,3428,20,80,60,20,0,0,0,0.5,10,60
96,1,1,5920,0,30,30,0,0,-10,10,,,40
96,2,2,3143,30,60,30,30,0,-10,10,-0.333333333,30,40
96,3,3,4726,0,70,70,0,0,10,10,,,60
96,4,4,3579,-20,40,60,20,0,0,0,1,-10,60
96,5,5,2777,0,20,20,0,0,-20,20,,,40
96,6,6,3401,-10,40,50,10,0,10,10,3,-10,40
96,7,7,4865,10,50,40,10,0,-20,20,-4,10,60
96,8,8,2912,30,50,20,30,0,-20,20,0.333333333,30,40
96,9,9,2463,60,60,0,60,0,-60,60,1.333333333,50,60
96,10,10,3459,0,30,30,0,0,-10,10,,,40
96,11,11,3729,0,80,80,0,0,20,20,,,60
96,12,12,3546,0,70,70,0,0,10,10,,,60
96,13,13,3809,-10,40,50,10,0,10,10,1,-10,40
96,14,14,4136,10,60,50,10,0,-10,10,3,10,60
96,15,15,3688,-20,20,40,20,0,0,0,1,-10,40
96,16,16,2765,-30,50,80,30,0,20,20,0,-30,60
96,17,17,4685,30,50,20,30,0,-20,20,1.333333333,30,40
96,18,18,2680,-40,40,80,40,0,20,20,1.25,-50,60
96,19,19,5209,0,60,60,0,0,20,20,,,40
96,20,20,4964,10,40,30,10,0,-30,30,1,10,60
96,21,21,3199,20,60,40,20,0,-20,20,2,10,60
96,22,22,3664,-30,40,70,30,0,30,30,1.666666667,-30,40
96,23,23,2857,30,50,20,30,0,-20,20,1,30,40
96,24,24,3465,0,80,80,0,0,20,20,,,60
96,25,25,4505,-20,30,50,20,0,10,10,1,-10,40
96,26,26,4052,-10,20,30,10,0,-10,10,0,-10,40
96,27,27,3644,-10,50,60,10,0,0,0,1,-10,60
96,28,28,3454,20,70,50,20,0,-10,10,,10,60
96,29,29,3254,30,60,30,30,0,-10,10,,30,40
96,30,0,4700,50,80,30,50,1,-10,10,1.2,50,40
96,31,1,3314,-10,40,50,10,1,-10,10,-1,-10,60
96,32,2,2724,-70,20,90,70,1,50,50,0.714285714,-70,40
96,33,3,4033,0,60,60,0,1,0,0,,,60
96,34,4,3384,0,40,40,0,1,0,0,,,40
96,35,5,3606,-20,0,20,20,1,-20,20,-2,-10,40
96,36,6,3057,-60,20,80,60,1,20,20,0.333333333,-50,60
96,37,7,4553,40,100,60,40,1,0,0,0.5,50,60
96,38,8,4619,0,60,60,0,1,20,20,,,40
96,39,9,3964,0,80,80,0,1,20,20,,,60
96,40,10,4225,80,100,20,80,1,-40,40,1,70,60
96,41,11,2823,-40,0,40,40,1,0,0,-0.75,-50,40
96,42,12,5110,-50,20,70,50,1,30,30,-0.4,-50,40
96,43,13,3856,-60,40,100,60,1,40,40,0.166666667,-50,60
96,44,14,5008,-50,40,90,50,1,50,50,0.4,-50,40
96,45,15,4480,-30,60,90,30,1,30,30,1.666666667,-30,60
96,46,16,3867,10,80,70,10,1,30,30,0,10,40
96,47,17,6399,40,80,40,40,1,-20,20,0.25,50,60
96,48,18,3752,-30,20,50,30,1,-10,10,-1.666666667,-30,60
96,49,19,4751,-10,60,70,10,1,30,30,3,-10,40
96,50,20,3818,-20,20,40,20,1,0,0,1,-10,40
96,51,21,3447,-80,20,100,80,1,40,40,0.625,-70,60
96,52,22,4026,-10,40,50,10,1,-10,10,-1,-10,60
96,53,23,4168,-20,0,20,20,1,-20,20,-1.5,-10,40
96,54,24,4480,40,100,60,40,1,0,0,0.5,50,60
96,55,25,4572,-10,40,50,10,1,10,10,5,-10,40
96,56,26,4052,0,80,80,0,1,20,20,,,60
96,57,27,5168,60,60,0,60,1,-40,40,0.166666667,50,40
96,58,28,4682,70,80,10,70,1,-30,30,,70,40
96,59,29,5029,0,60,60,0,1,0,0,,,60
97,0,0,3359,-10,60,70,10,1,30,30,3,-10,40
97,1,1,2642,20,40,20,20,1,-40,40,1.5,10,60
97,2,2,2710,-20,20,40,20,1,0,0,-1,-10,40
97,3,3,2489,10,60,50,10,1,-10,10,-2,10,60
97,4,4,2970,20,80,60,20,1,20,20,0,10,40
97,5,5,4092,-60,0,60,60,1,20,20,0.166666667,-50,40
97,6,6,3030,50,80,30,50,1,-30,30,0.6,50,60
97,7,7,3372,40,100,60,40,1,0,0,0,50,60
97,8,8,3044,-10,40,50,10,1,10,10,1,-10,40
97,9,9,3627,-40,20,60,40,1,0,0,-0.5,-50,60
97,10,10,3228,-20,60,80,20,1,20,20,0,-10,60
97,11,11,3809,20,60,40,20,1,0,0,-0.5,10,40
97,12,12,3391,50,80,30,50,1,-10,10,0.2,50,40
97,13,13,2863,-60,20,80,60,1,20,20,0,-50,60
97,14,14,3733,0,40,40,0,1,0,0,,,40
97,15,15,3503,-40,40,80,40,1,20,20,1,-50,60
97,16,16,3891,-30,20,50,30,1,10,10,0,-30,40
97,17,17,3854,40,80,40,40,1,-20,20,0.5,50,60
97,18,18,2812,40,100,60,40,1,0,0,-1,50,60
97,19,19,4268,-50,0,50,50,1,10,10,-0.4,-50,40
97,20,20,2822,10,80,70,10,1,30,30,-3,10,40
97,21,21,2741,20,40,20,20,1,-40,40,2,10,60
97,22,22,3082,-40,20,60,40,1,0,0,-1,-50,60
97,23,23,4042,20,60,40,20,1,0,0,1,10,40
97,24,24,3069,-40,60,100,40,1,40,40,0.5,-50,60
97,25,25,2949,-20,40,60,20,1,20,20,1,-10,40
97,26,26,2974,20,100,80,20,1,20,20,0,10,60
97,27,27,3087,-20,20,40,20,1,0,0,1,-10,40
97,28,28,3840,-20,0,20,20,1,-20,20,,-10,40
97,29,29,3780,0,80,80,0,1,20,20,,,60
97,30,0,2939,-20,40,60,20,0,0,0,1,-10,60
97,31,1,3806,0,60,60,0,0,20,20,,,40
97,32,2,2870,-30,50,80,30,0,40,40,0.333333333,-30,40
97,33,3,3277,10,50,40,10,0,-20,20,-1,10,60
97,34,4,4205,50,80,30,50,0,-30,30,0.2,50,60
97,35,5,4510,-30,40,70,30,0,30,30,1.666666667,-30,40
97,36,6,3257,10,30,20,10,0,-20,20,3,10,40
97,37,7,2910,20,60,40,20,0,-20,20,1,10,60
97,38,8,3889,-30,20,50,30,0,10,10,1,-30,40
97,39,9,2702,10,70,60,10,0,0,0,4,10,60
97,40,10,3918,10,30,20,10,0,-20,20,2,10,40
97,41,11,3857,-20,80,100,20,0,40,40,2,-10,60
97,42,12,3899,10,70,60,10,0,0,0,0,10,60
97,43,13,4410,-20,20,40,20,0,0,0,1,-10,40
97,44,14,2840,0,60,60,0,0,0,0,,,60
97,45,15,3099,20,40,20,20,0,-20,20,2,10,40
97,46,16,3786,-10,50,60,10,0,0,0,4,-10,60
97,47,17,4045,0,60,60,0,0,20,20,,,40
97,48,18,3022,20,40,20,20,0,-40,40,-1,10,60
97,49,19,3152,20,50,30,20,0,-10,10,0.5,10,40
97,50,20,2749,60,60,0,60,0,-60,60,1,50,60
97,51,21,3024,10,70,60,10,0,0,0,2,10,60
97,52,22,2592,10,50,40,10,0,0,0,2,10,40
97,53,23,4305,0,60,60,0,0,20,20,,,40
97,54,24,2669,-40,40,80,40,0,20,20,0.5,-50,60
97,55,25,3085,10,30,20,10,0,-20,20,2,10,40
97,56,26,2630,0,40,40,0,0,0,0,,,40
97,57,27,2976,-10,50,60,10,0,0,0,2,-10,60
97,58,28,2750,40,80,40,40,0,-20,20,,50,60
97,59,29,3332,-40,20,60,40,0,20,20,,-50,40
98,0,0,3864,-10,50,60,10,0,0,0,1,-10,60
98,1,1,4454,-20,60,80,20,0,40,40,0.5,-10,40
98,2,2,4126,-40,30,70,40,0,30,30,1,-50,40
98,3,3,3213,20,70,50,20,0,-10,10,1.5,10,60
98,4,4,3894,0,80,80,0,0,20,20,,,60
98,5,5,3367,-10,20,30,10,0,-10,10,-2,-10,40
98,6,6,4208,-10,40,50,10,0,10,10,1,-10,40
98,7,7,3668,-10,60,70,10,0,10,10,0,-10,60
98,8,8,3470,10,50,40,10,0,0,0,1,10,40
98,9,9,4806,-30,40,70,30,0,10,10,0.333333333,-30,60
98,10,10,3071,-30,20,50,30,0,10,10,0.333333333,-30,40
98,11,11,3886,0,60,60,0,0,0,0,,,60
98,12,12,4185,0,70,70,0,0,10,10,,,60
98,13,13,3716,20,60,40,20,0,0,0,0.5,10,40
98,14,14,3161,20,80,60,20,0,0,0,1,10,60
98,15,15,2930,-10,40,50,10,0,10,10,1,-10,40
98,16,16,4458,-30,50,80,30,0,20,20,0.666666667,-30,60
98,17,17,3310,10,50,40,10,0,0,0,-1,10,40
98,18,18,3409,-20,40,60,20,0,0,0,-0.5,-10,60
98,19,19,3260,0,30,30,0,0,-10,10,,,40
98,20,20,2917,0,70,70,0,0,10,10,,,60
98,21,21,4653,-10,40,50,10,0,-10,10,0,-10,60
98,22,22,3887,10,60,50,10,0,10,10,-1,10,40
98,23,23,2934,10,50,40,10,0,0,0,2,10,40
98,24,24,4152,10,60,50,10,0,-10,10,1,10,60
98,25,25,3104,-30,30,60,30,0,20,20,1,-30,40
98,26,26,3317,10,40,30,10,0,-10,10,0,10,40
98,27,27,3167,20,80,60,20,0,0,0,0.5,10,60
98,28,28,3149,-20,50,70,20,0,10,10,,-10,60
98,29,29,3325,-10,20,30,10,0,-10,10,,-10,40
98,30,0,3165,-50,0,50,50,1,10,10,0.6,-50,40
98,31,1,4726,-10,40,50,10,1,-10,10,-1,-10,60
98,32,2,4911,0,20,20,0,1,-20,20,,,40
98,33,3,3257,0,60,60,0,1,0,0,,,60
98,34,4,3136,30,60,30,30,1,-10,10,0.666666667,30,40
98,35,5,3558,30,80,50,30,1,10,10,-0.666666667,30,40
98,36,6,3361,40,100,60,40,1,0,0,,50,60
98,37,7,2879,,20,,,1,,,,,60
98,38,8,4102,10,40,30,10,1,-10,10,0,10,40
98,39,9,2944,30,80,50,30,1,-10,10,0,30,60
98,40,10,4078,-30,20,50,30,1,-10,10,-0.333333333,-30,60
98,41,11,4080,-30,0,30,30,1,-10,10,0,-30,40
98,42,12,4210,50,80,30,50,1,-10,10,0.5,50,40
98,43,13,3034,40,100,60,40,1,0,0,-0.5,50,60
98,44,14,7003,5,60,55,5,1,15,15,1,10,40
98,45,15,4772,20,60,40,20,1,-20,20,1.5,10,60
98,46,16,3507,-40,20,60,40,1,20,20,0.5,-50,40
98,47,17,3895,-30,40,70,30,1,10,10,0.333333333,-30,60
98,48,18,3911,20,80,60,20,1,0,0,0,10,60
98,49,19,4470,0,40,40,0,1,0,0,,,40
98,50,20,3584,-50,0,50,50,1,10,10,0.2,-50,40
98,51,21,4916,-20,40,60,20,1,0,0,-1,-10,60
98,52,22,2963,-20,60,80,20,1,20,20,1.5,-10,60
98,53,23,4492,20,60,40,20,1,0,0,-0.5,10,40
98,54,24,3070,-30,20,50,30,1,-10,10,0,-30,60
98,55,25,3631,10,40,30,10,1,-10,10,2,10,40
98,56,26,3873,50,100,50,50,1,-10,10,0.2,50,60
98,57,27,4133,30,80,50,30,1,10,10,-0.333333333,30,40
98,58,28,4288,-20,20,40,20,1,0,0,,-10,40
98,59,29,4461,20,80,60,20,1,0,0,,10,60
99,0,0,5457,-40,40,80,40,0,20,20,1.25,-50,60
99,1,1,4703,0,50,50,0,0,10,10,,,40
99,2,2,4283,0,60,60,0,0,20,20,,,40
99,3,3,4377,40,70,30,40,0,-30,30,1,50,60
99,4,4,4743,10,80,70,10,0,10,10,-1,10,60
99,5,5,5701,-10,40,50,10,0,10,10,0,-10,40
99,6,6,5631,-20,30,50,20,0,10,10,0.5,-10,40
99,7,7,5499,-10,50,60,10,0,0,0,-1,-10,60
99,8,8,5450,-20,20,40,20,0,0,0,1,-10,40
99,9,9,3616,-10,60,70,10,0,10,10,1,-10,60
99,10,10,3540,40,60,20,40,0,-20,20,0.25,50,40
99,11,11,4936,0,60,60,0,0,0,0,,,60
99,12,12,4728,-20,50,70,20,0,10,10,-0.5,-10,60
99,13,13,5498,-10,20,30,10,0,-10,10,-2,-10,40
99,14,14,4759,-10,70,80,10,0,20,20,2,-10,60
99,15,15,4709,0,50,50,0,0,10,10,,,40
99,16,16,3462,-20,40,60,20,0,0,0,-0.5,-10,60
99,17,17,6561,10,40,30,10,0,-10,10,3,10,40
99,18,18,6324,10,80,70,10,0,10,10,2,10,60
99,19,19,5424,-30,30,60,30,0,20,20,1.333333333,-30,40
99,20,20,6435,-20,70,90,20,0,30,30,1,-10,60
99,21,21,3445,-10,60,70,10,0,10,10,2,-10,60
99,22,22,5515,30,50,20,30,0,-20,20,0.333333333,30,40
99,23,23,5278,0,30,30,0,0,-10,10,,,40
99,24,24,4458,-10,40,50,10,0,-10,10,1,-10,60
99,25,25,6473,0,40,40,0,0,0,0,,,40
99,26,26,5433,0,20,20,0,0,-20,20,,,40
99,27,27,5338,10,50,40,10,0,-20,20,2,10,60
99,28,28,6235,20,80,60,20,0,0,0,,10,60
99,29,29,4205,40,60,20,40,0,-20,20,,50,40
99,30,0,5550,-20,20,40,20,1,0,0,0,-10,40
99,31,1,4415,40,100,60,40,1,0,0,-0.25,50,60
99,32,2,4708,40,80,40,40,1,0,0,0,50,40
99,33,3,4741,-10,40,50,10,1,-10,10,0,-10,60
99,34,4,4014,0,40,40,0,1,0,0,,,40
99,35,5,4408,-50,0,50,50,1,10,10,-0.2,-50,40
99,36,6,4969,10,60,50,10,1,-10,10,-1,10,60
99,37,7,4944,-20,20,40,20,1,-20,20,-1.5,-10,60
99,38,8,5073,0,60,60,0,1,20,20,,,40
99,39,9,4129,10,80,70,10,1,10,10,3,10,60
99,40,10,3629,-40,60,100,40,1,40,40,2.5,-50,60
99,41,11,5763,0,60,60,0,1,20,20,,,40
99,42,12,4625,-40,0,40,40,1,0,0,-0.25,-50,40
99,43,13,3119,40,40,0,40,1,-60,60,0.5,50,60
99,44,14,6240,30,80,50,30,1,10,10,0.666666667,30,40
99,45,15,5533,60,80,20,60,1,-40,40,0.5,50,60
99,46,16,5187,-50,20,70,50,1,30,30,0.2,-50,40
99,47,17,5068,50,100,50,50,1,-10,10,0.6,50,60
99,48,18,4661,-60,20,80,60,1,20,20,0.666666667,-50,60
99,49,19,6364,-20,40,60,20,1,20,20,0,-10,40
99,50,20,3472,0,60,60,0,1,20,20,,,40
99,51,21,5399,40,80,40,40,1,-20,20,0,50,60
99,52,22,5330,0,40,40,0,1,-20,20,,,60
99,53,23,4339,-100,0,100,100,1,60,60,0.4,-70,40
99,54,24,4265,30,60,30,30,1,-30,30,2.333333333,30,60
99,55,25,4967,20,80,60,20,1,20,20,-0.5,10,40
99,56,26,3624,-80,20,100,80,1,40,40,0,-70,60
99,57,27,7002,-30,20,50,30,1,10,10,-0.333333333,-30,40
99,58,28,3397,-20,40,60,20,1,20,20,,-10,40
99,59,29,4038,0,100,100,0,1,40,40,,,60
100,0,0,5321,10,70,60,10,0,0,0,2,10,60
100,1,1,4031,-20,20,40,20,0,0,0,0,-10,40
100,2,2,5196,10,50,40,10,0,0,0,1,10,40
100,3,3,4445,0,80,80,0,0,20,20,,,60
100,4,4,3883,-30,50,80,30,0,20,20,0.166666667,-30,60
100,5,5,3872,-10,40,50,10,0,10,10,1,-10,40
100,6,6,4208,20,60,40,20,0,0,0,0.5,10,40
100,7,7,4772,-15,60,75,15,0,15,15,-0.333333333,-10,60
100,8,8,3569,-20,30,50,20,0,10,10,-0.5,-10,40
100,9,9,4878,-40,40,80,40,0,20,20,0.25,-50,60
100,10,10,3759,-10,50,60,10,0,20,20,1,-10,40
100,11,11,3680,-10,60,70,10,0,10,10,0,-10,60
100,12,12,3995,0,70,70,0,0,10,10,,,60
100,13,13,3410,-30,20,50,30,0,10,10,0.666666667,-30,40
100,14,14,4258,-20,40,60,20,0,0,0,2,-10,60
100,15,15,7009,30,60,30,30,0,-10,10,0.333333333,30,40
100,16,16,5446,30,50,20,30,0,-40,40,2,30,60
100,17,17,3919,-10,30,40,10,0,0,0,0,-10,40
100,18,18,3746,0,80,80,0,0,20,20,,,60
100,19,19,4822,0,40,40,0,0,0,0,,,40
100,20,20,4290,-30,40,70,30,0,10,10,0.333333333,-30,60
100,21,21,4008,-10,50,60,10,0,0,0,0,-10,60
100,22,22,3356,-20,20,40,20,0,0,0,0,-10,40
100,23,23,4277,-10,30,40,10,0,0,0,2,-10,40
100,24,24,3196,20,80,60,20,0,0,0,-0.5,10,60
100,25,25,3919,20,40,20,20,0,-20,20,1,10,40
100,26,26,3310,10,50,40,10,0,0,0,-1,10,40
100,27,27,3491,20,70,50,20,0,-10,10,1,10,60
100,28,28,4379,-10,60,70,10,0,10,10,,-10,60
100,29,29,3590,30,60,30,30,0,-10,10,,30,40
100,30,0,6650,-60,0,60,60,1,20,20,0.166666667,-50,40
100,31,1,4946,-10,20,30,10,1,-30,30,-3,-10,60
100,32,2,4266,-10,40,50,10,1,10,10,-3,-10,40
100,33,3,3482,40,100,60,40,1,0,0,0.25,50,60
100,34,4,3790,0,80,80,0,1,40,40,,,40
100,35,5,3611,-60,20,80,60,1,40,40,0.5,-50,40
100,36,6,3377,-10,60,70,10,1,10,10,3,-10,60
100,37,7,4844,40,80,40,40,1,-20,20,0.25,50,60
100,38,8,4233,10,60,50,10,1,10,10,0,10,40
100,39,9,5818,-10,40,50,10,1,-10,10,1,-10,60
100,40,10,4346,40,80,40,40,1,-20,20,-0.25,50,60
100,41,11,4615,30,80,50,30,1,10,10,1.333333333,30,40
100,42,12,4109,-50,40,90,50,1,50,50,1.2,-50,40
100,43,13,4186,10,40,30,10,1,-30,30,4,10,60
100,44,14,4626,30,60,30,30,1,-10,10,1.666666667,30,40
100,45,15,5076,-10,60,70,10,1,10,10,3,-10,60
100,46,16,4004,-80,0,80,80,1,40,40,0.25,-70,40
100,47,17,3673,60,100,40,60,1,-20,20,0.5,50,60
100,48,18,4467,-50,20,70,50,1,10,10,0.6,-50,60
100,49,19,4019,-40,20,60,40,1,20,20,0.5,-50,40
100,50,20,3960,40,80,40,40,1,0,0,0,50,40
100,51,21,3973,60,100,40,60,1,-20,20,0.333333333,50,60
100,52,22,3333,-20,40,60,20,1,0,0,-1,-10,60
100,53,23,3883,-40,0,40,40,1,0,0,-0.25,-50,40
100,54,24,3567,0,80,80,0,1,20,20,,,60
100,55,25,4896,-30,20,50,30,1,10,10,0.333333333,-30,40
100,56,26,3816,0,60,60,0,1,0,0,,,60
100,57,27,3909,20,60,40,20,1,0,0,2,10,40
100,58,28,3911,-40,40,80,40,1,40,40,,-50,40
100,59,29,5362,-10,20,30,10,1,-30,30,,-10,60
101,0,0,6271,-70,20,90,70,1,50,50,0.857142857,-70,40
101,1,1,3417,-20,40,60,20,1,0,0,0.5,-10,60
101,2,2,3132,50,80,30,50,1,-10,10,0.8,50,40
101,3,3,3267,10,60,50,10,1,-10,10,3,10,60
101,4,4,3218,-70,0,70,70,1,30,30,0.142857143,-70,40
101,5,5,3530,0,60,60,0,1,20,20,,,40
101,6,6,3370,20,100,80,20,1,20,20,-0.5,10,60
101,7,7,3401,-50,20,70,50,1,10,10,-0.4,-50,60
101,8,8,3146,20,40,20,20,1,-20,20,-0.5,10,40
101,9,9,3186,-10,80,90,10,1,30,30,4,-10,60
101,10,10,3642,30,80,50,30,1,-10,10,-1,30,60
101,11,11,3795,-10,0,10,10,1,-30,30,-7,-10,40
101,12,12,3171,-20,60,80,20,1,40,40,-0.5,-10,40
101,13,13,3442,40,60,20,40,1,-40,40,0.5,50,60
101,14,14,3059,-50,40,90,50,1,50,50,1,-50,40
101,15,15,3441,60,100,40,60,1,-20,20,0,50,60
101,16,16,3834,40,80,40,40,1,0,0,1.5,50,40
101,17,17,3397,-20,20,40,20,1,-20,20,-2.5,-10,60
101,18,18,3458,-50,40,90,50,1,30,30,1.4,-50,60
101,19,19,3689,-80,20,100,80,1,60,60,0.375,-70,40
101,20,20,3722,-30,40,70,30,1,30,30,1.666666667,-30,40
101,21,21,3346,0,20,20,0,1,-40,40,,,60
101,22,22,2970,40,100,60,40,1,0,0,0,50,60
101,23,23,3306,60,80,20,60,1,-20,20,0.666666667,50,40
101,24,24,4410,-20,40,60,20,1,0,0,3,-10,60
101,25,25,3275,-40,20,60,40,1,20,20,1.5,-50,40
101,26,26,3162,60,60,0,60,1,-60,60,0.333333333,50,60
101,27,27,3122,0,0,0,0,1,-40,40,,,40
101,28,28,4050,0,60,60,0,1,20,20,,,40
101,29,29,3698,60,80,20,60,1,-40,40,,50,60
101,30,0,4104,30,50,20,30,0,-40,40,1,30,60
101,31,1,3132,-60,20,80,60,0,40,40,0.333333333,-50,40
101,32,2,2985,-30,30,60,30,0,20,20,1.333333333,-30,40
101,33,3,3627,10,60,50,10,0,-10,10,5,10,60
101,34,4,3762,-60,40,100,60,0,40,40,1.166666667,-50,60
101,35,5,3675,40,60,20,40,0,-20,20,-0.5,50,40
101,36,6,3137,50,50,0,50,0,-40,40,0.4,50,40
101,37,7,3234,50,80,30,50,0,-30,30,0.6,50,60
101,38,8,3346,20,40,20,20,0,-20,20,0,10,40
101,39,9,3093,10,70,60,10,0,0,0,0,10,60
101,40,10,3058,30,50,20,30,0,-20,20,0.666666667,30,40
101,41,11,3874,20,80,60,20,0,0,0,0,10,60
101,42,12,3146,-10,50,60,10,0,0,0,0,-10,60
101,43,13,3690,0,40,40,0,0,0,0,,,40
101,44,14,4819,0,60,60,0,0,0,0,,,60
101,45,15,3058,-10,30,40,10,0,0,0,-1,-10,40
101,46,16,3434,-50,40,90,50,0,30,30,0.2,-50,60
101,47,17,3921,10,60,50,10,0,10,10,1,10,40
101,48,18,4355,-10,70,80,10,0,20,20,1,-10,60
101,49,19,3481,-40,20,60,40,0,20,20,1,-50,40
101,50,20,3050,0,70,70,0,0,10,10,,,60
101,51,21,3786,40,80,40,40,0,-20,20,0.75,50,60
101,52,22,3786,20,40,20,20,0,-20,20,2,10,40
101,53,23,3738,-30,30,60,30,0,20,20,1.333333333,-30,40
101,54,24,4426,-10,60,70,10,0,10,10,-2,-10,60
101,55,25,2993,0,20,20,0,0,-20,20,,,40
101,56,26,2970,0,50,50,0,0,10,10,,,40
101,57,27,3209,-40,50,90,40,0,30,30,0.5,-50,60
101,58,28,3138,-30,40,70,30,0,10,10,,-30,60
101,59,29,3595,20,60,40,20,0,0,0,,10,40
102,0,0,3121,10,60,50,10,1,10,10,2,10,40
102,1,1,2929,-50,20,70,50,1,10,10,0.7,-50,60
102,2,2,3066,-50,20,70,50,1,30,30,0.4,-50,40
102,3,3,3287,5,40,35,5,1,-25,25,0,10,60
102,4,4,3029,-10,40,50,10,1,10,10,-1,-10,40
102,5,5,3978,-60,0,60,60,1,20,20,-0.083333333,-50,40
102,6,6,4072,65,100,35,65,1,-25,25,0.384615385,70,60
102,7,7,3211,20,80,60,20,1,0,0,-1,10,60
102,8,8,3728,15,80,65,15,1,25,25,-0.333333333,10,40
102,9,9,2879,20,60,40,20,1,-20,20,0,10,60
102,10,10,2921,20,60,40,20,1,-20,20,0,10,60
102,11,11,3650,20,80,60,20,1,20,20,0,10,40
102,12,12,3471,-20,40,60,20,1,20,20,0.25,-10,40
102,13,13,3664,-20,20,40,20,1,-20,20,-0.5,-10,60
102,14,14,2895,-55,0,55,55,1,15,15,0.090909091,-50,40
102,15,15,4818,-10,40,50,10,1,-10,10,2,-10,60
102,16,16,2790,-30,20,50,30,1,10,10,-0.333333333,-30,40
102,17,17,3351,50,80,30,50,1,-30,30,0.2,50,60
102,18,18,4436,60,100,40,60,1,-20,20,0,50,60
102,19,19,2863,0,60,60,0,1,20,20,,,40
102,20,20,2830,-20,40,60,20,1,20,20,0,-10,40
102,21,21,2801,40,80,40,40,1,-20,20,-0.125,50,60
102,22,22,4895,65,100,35,65,1,-25,25,0.076923077,70,60
102,23,23,3129,-60,0,60,60,1,20,20,0,-50,40
102,24,24,3909,20,60,40,20,1,-20,20,0,10,60
102,25,25,3370,-40,20,60,40,1,20,20,0,-50,40
102,26,26,2960,0,40,40,0,1,-20,20,,,60
102,27,27,3355,20,80,60,20,1,20,20,-0.25,10,40
102,28,28,2812,5,60,55,5,1,15,15,,10,40
102,29,29,4052,-15,20,35,15,1,-25,25,,-10,60
102,30,0,4056,50,70,20,50,0,-40,40,0.8,50,60
102,31,1,3521,30,60,30,30,0,-10,10,0,30,40
102,32,2,3032,20,50,30,20,0,-10,10,0.5,10,40
102,33,3,3890,0,60,60,0,0,0,0,,,60
102,34,4,2849,-20,40,60,20,0,0,0,0,-10,60
102,35,5,2685,0,40,40,0,0,0,0,,,40
102,36,6,3580,-15,30,45,15,0,5,5,0.666666667,-10,40
102,37,7,3835,-10,50,60,10,0,0,0,0.5,-10,60
102,38,8,2845,-15,20,35,15,0,-5,5,0,-10,40
102,39,9,3264,25,80,55,25,0,-5,5,0.4,30,60
102,40,10,4053,25,60,35,25,0,-5,5,0.2,30,40
102,41,11,3392,15,80,65,15,0,5,5,-1.666666667,10,60
102,42,12,4424,30,70,40,30,0,-20,20,0.833333333,30,60
102,43,13,5722,-10,30,40,10,0,0,0,0.5,-10,40
102,44,14,3335,-25,40,65,25,0,5,5,0.2,-30,60
102,45,15,3220,5,40,35,5,0,-5,5,0,10,40
102,46,16,3913,-10,50,60,10,0,0,0,0,-10,60
102,47,17,2977,-15,20,35,15,0,-5,5,-0.333333333,-10,40
102,48,18,3065,0,60,60,0,0,0,0,,,60
102,49,19,3507,10,50,40,10,0,0,0,-1,10,40
102,50,20,2793,20,80,60,20,0,0,0,0,10,60
102,51,21,2778,-10,50,60,10,0,0,0,0,-10,60
102,52,22,4063,0,30,30,0,0,-10,10,,,40
102,53,23,2917,-15,20,35,15,0,-5,5,0,-10,40
102,54,24,2903,0,60,60,0,0,0,0,,,60
102,55,25,3795,15,50,35,15,0,-5,5,0,10,40
102,56,26,2956,5,40,35,5,0,-5,5,0,10,40
102,57,27,2876,10,70,60,10,0,0,0,0,10,60
102,58,28,2778,-20,40,60,20,0,0,0,,-10,60
102,59,29,3021,25,60,35,25,0,-5,5,,30,40
103,0,0,6389,-10,20,30,10,1,-10,10,-5,-10,40
103,1,1,3645,40,60,20,40,1,-40,40,0.75,50,60
103,2,2,3512,-20,60,80,20,1,40,40,3,-10,40
103,3,3,3459,-10,40,50,10,1,-10,10,2,-10,60
103,4,4,3280,60,80,20,60,1,-20,20,1.166666667,50,40
103,5,5,5091,-50,40,90,50,1,50,50,0.4,-50,40
103,6,6,8772,-10,20,30,10,1,-30,30,-3,-10,60
103,7,7,4782,20,80,60,20,1,0,0,-1,10,60
103,8,8,4528,-70,0,70,70,1,30,30,-0.428571429,-70,40
103,9,9,4843,60,100,40,60,1,-20,20,0.333333333,50,60
103,10,10,5282,40,100,60,40,1,0,0,0,50,60
103,11,11,3528,-80,20,100,80,1,60,60,0.5,-70,40
103,12,12,4371,-20,40,60,20,1,20,20,-0.5,-10,40
103,13,13,4312,0,60,60,0,1,0,0,,,60
103,14,14,3332,10,80,70,10,1,30,30,0,10,40
103,15,15,5577,-10,40,50,10,1,-10,10,-1,-10,60
103,16,16,4599,-70,0,70,70,1,30,30,0.785714286,-70,40
103,17,17,4419,20,80,60,20,1,0,0,,10,60
103,18,18,7703,,20,,,1,,,,,60
103,19,19,4066,45,60,15,45,1,-25,25,0.777777778,50,40
103,20,20,6230,30,80,50,30,1,10,10,0.666666667,30,40
103,21,21,5192,-30,40,70,30,1,10,10,0.666666667,-30,60
103,22,22,4444,30,80,50,30,1,-10,10,-1,30,60
103,23,23,5425,-10,60,70,10,1,30,30,1,-10,40
103,24,24,4746,0,20,20,0,1,-40,40,,,60
103,25,25,4938,-60,0,60,60,1,20,20,0.5,-50,40
103,26,26,5994,50,100,50,50,1,-10,10,1,50,60
103,27,27,5164,10,40,30,10,1,-10,10,6,10,40
103,28,28,5776,-70,20,90,70,1,50,50,,-70,40
103,29,29,5071,-40,60,100,40,1,40,40,,-50,60
103,30,0,6552,60,80,20,60,0,-40,40,0.666666667,50,60
103,31,1,6029,40,50,10,40,0,-30,30,,50,40
103,32,2,7005,,30,,,0,,,,,40
103,33,3,4599,-10,50,60,10,0,0,0,3,-10,60
103,34,4,6546,10,40,30,10,0,-30,30,4,10,60
103,35,5,4502,0,60,60,0,0,20,20,,,40
103,36,6,5588,-10,40,50,10,0,10,10,1,-10,40
103,37,7,4116,0,70,70,0,0,10,10,,,60
103,38,8,4329,-20,20,40,20,0,0,0,-3,-10,40
103,39,9,4577,35,60,25,35,0,-35,35,1.571428571,30,60
103,40,10,3541,-70,30,100,70,0,60,60,0.542857143,-70,40
103,41,11,4791,-20,60,80,20,0,20,20,-0.5,-10,60
103,42,12,4799,-40,50,90,40,0,30,30,0.75,-50,60
103,43,13,6043,-12,50,62,12,0,22,22,-3.166666667,-10,40
103,44,14,5807,-20,40,60,20,0,0,0,2,-10,60
103,45,15,4765,-60,40,100,60,0,60,60,0.666666667,-50,40
103,46,16,4839,60,80,20,60,0,-40,40,1.166666667,50,60
103,47,17,5520,0,60,60,0,0,20,20,,,40
103,48,18,6408,-20,70,90,20,0,30,30,3.5,-10,60
103,49,19,4544,-40,20,60,40,0,20,20,1,-50,40
103,50,20,4271,20,40,20,20,0,-40,40,0,10,60
103,51,21,4753,40,60,20,40,0,-40,40,1.75,50,60
103,52,22,4207,20,40,20,20,0,-20,20,3.25,10,40
103,53,23,5587,-65,20,85,65,0,45,45,0.461538462,-70,40
103,54,24,5071,-20,70,90,20,0,30,30,2,-10,60
103,55,25,7061,-25,30,55,25,0,15,15,-0.2,-30,40
103,56,26,4421,-10,50,60,10,0,20,20,-3,-10,40
103,57,27,4347,0,50,50,0,0,-10,10,,,60
103,58,28,4566,20,80,60,20,0,0,0,,10,60
103,59,29,5455,-30,60,90,30,0,50,50,,-30,40
104,0,0,5327,30,80,50,30,1,10,10,-0.333333333,30,40
104,1,1,3381,50,80,30,50,1,-30,30,0.6,50,60
104,2,2,4064,-40,0,40,40,1,0,0,0.25,-50,40
104,3,3,3465,40,100,60,40,1,0,0,0.5,50,60
104,4,4,3590,-10,20,30,10,1,-10,10,1,-10,40
104,5,5,3779,20,40,20,20,1,-20,20,1.5,10,40
104,6,6,2758,-60,20,80,60,1,20,20,0.666666667,-50,60
104,7,7,4094,20,60,40,20,1,-20,20,1,10,60
104,8,8,3264,10,60,50,10,1,10,10,-1,10,40
104,9,9,3396,-20,40,60,20,1,0,0,-0.5,-10,60
104,10,10,3693,-30,40,70,30,1,10,10,-0.333333333,-30,60
104,11,11,3502,40,80,40,40,1,0,0,0.5,50,40
104,12,12,3642,-20,40,60,20,1,20,20,1,-10,40
104,13,13,4423,0,80,80,0,1,20,20,,,60
104,14,14,4370,-40,0,40,40,1,0,0,0.25,-50,40
104,15,15,6372,10,60,50,10,1,-10,10,1,10,60
104,16,16,3430,-10,20,30,10,1,-10,10,-2,-10,40
104,17,17,4062,40,100,60,40,1,0,0,0.25,50,60
104,18,18,3580,-50,20,70,50,1,10,10,0.4,-50,60
104,19,19,3308,10,60,50,10,1,10,10,-2,10,40
104,20,20,3211,-10,20,30,10,1,-10,10,-2,-10,40
104,21,21,2373,-10,40,50,10,1,-10,10,0,-10,60
104,22,22,3872,10,60,50,10,1,-10,10,5,10,60
104,23,23,3412,10,60,50,10,1,10,10,-4,10,40
104,24,24,3477,0,100,100,0,1,40,40,,,60
104,25,25,4215,30,40,10,30,1,-30,30,0,30,40
104,26,26,3452,-30,20,50,30,1,-10,10,0.333333333,-30,60
104,27,27,3121,70,80,10,70,1,-30,30,0.428571429,70,40
104,28,28,2481,-40,0,40,40,1,0,0,,-50,40
104,29,29,2621,40,80,40,40,1,-20,20,,50,60
104,30,0,3385,-50,40,90,50,0,30,30,1,-50,60
104,31,1,3009,-40,40,80,40,0,40,40,0.75,-50,40
104,32,2,2700,0,50,50,0,0,10,10,,,40
104,33,3,2924,40,80,40,40,0,-20,20,0.5,50,60
104,34,4,2645,0,60,60,0,0,0,0,,,60
104,35,5,4631,20,60,40,20,0,0,0,-0.5,10,40
104,36,6,2950,-10,20,30,10,0,-10,10,1,-10,40
104,37,7,2778,20,70,50,20,0,-10,10,1.5,10,60
104,38,8,3281,10,30,20,10,0,-20,20,-1,10,40
104,39,9,2909,-30,50,80,30,0,20,20,-0.333333333,-30,60
104,40,10,2921,20,30,10,20,0,-30,30,0.5,10,40
104,41,11,3219,-50,40,90,50,0,30,30,0.6,-50,60
104,42,12,3331,10,70,60,10,0,0,0,0,10,60
104,43,13,3976,0,20,20,0,0,-20,20,,,40
104,44,14,2932,-10,50,60,10,0,0,0,-2,-10,60
104,45,15,2976,60,60,0,60,0,-40,40,0.833333333,50,40
104,46,16,3341,0,80,80,0,0,20,20,,,60
104,47,17,3273,-10,40,50,10,0,10,10,4,-10,40
104,48,18,2876,0,60,60,0,0,0,0,,,60
104,49,19,3002,40,50,10,40,0,-30,30,0,50,40
104,50,20,2988,-30,60,90,30,0,30,30,0.333333333,-30,60
104,51,21,3037,-30,50,80,30,0,20,20,0.333333333,-30,60
104,52,22,3163,50,60,10,50,0,-30,30,0.4,50,40
104,53,23,3135,-10,20,30,10,0,-10,10,-1,-10,40
104,54,24,2873,-30,40,70,30,0,10,10,2.333333333,-30,60
104,55,25,3109,10,50,40,10,0,0,0,-2,10,40
104,56,26,2925,20,40,20,20,0,-20,20,0,10,40
104,57,27,2309,80,80,0,80,0,-60,60,1,70,60
104,58,28,3451,-10,70,80,10,0,20,20,,-10,60
104,59,29,3507,10,30,20,10,0,-20,20,,10,40
105,0,0,6100,,80,,,0,,,,,60
105,1,1,4504,,40,,,0,,,,,40
105,2,2,6151,0,20,20,0,0,-20,20,,,40
105,3,3,3627,20,60,40,20,0,-20,20,-0.5,10,60
105,4,4,3938,40,70,30,40,0,-30,30,0,50,60
105,5,5,4284,30,60,30,30,0,-10,10,0.666666667,30,40
105,6,6,3557,0,50,50,0,0,10,10,,,40
105,7,7,5485,10,40,30,10,0,-30,30,3,10,60
105,8,8,4457,-10,30,40,10,0,0,0,1,-10,40
105,9,9,4271,-10,50,60,10,0,0,0,1,-10,60
105,10,10,3672,0,30,30,0,0,-10,10,,,40
105,11,11,3721,0,50,50,0,0,-10,10,,,60
105,12,12,2918,0,60,60,0,0,0,0,,,60
105,13,13,2703,20,40,20,20,0,-20,20,0.5,10,40
105,14,14,3279,0,40,40,0,0,-20,20,,,60
105,15,15,3735,-10,20,30,10,0,-10,10,-2,-10,40
105,16,16,2873,40,80,40,40,0,-20,20,0.5,50,60
105,17,17,3235,0,50,50,0,0,10,10,,,40
105,18,18,3890,10,70,60,10,0,0,0,-1,10,60
105,19,19,2660,40,60,20,40,0,-20,20,0.75,50,40
105,20,20,2690,-10,40,50,10,0,-10,10,-2,-10,60
105,21,21,3134,10,80,70,10,0,10,10,-2,10,60
105,22,22,4175,10,60,50,10,0,10,10,1,10,40
105,23,23,4915,-10,50,60,10,0,20,20,2,-10,40
105,24,24,3658,0,50,50,0,0,-10,10,,,60
105,25,25,2586,-20,20,40,20,0,0,0,1,-10,40
105,26,26,3577,10,30,20,10,0,-20,20,1,10,40
105,27,27,2602,30,70,40,30,0,-20,20,1.333333333,30,60
105,28,28,2643,-20,60,80,20,0,20,20,,-10,60
105,29,29,5106,10,40,30,10,0,-10,10,,10,40
105,30,0,5552,30,60,30,30,1,-10,10,0.666666667,30,40
105,31,1,4457,0,20,20,0,1,-40,40,,,60
105,32,2,4745,-10,40,50,10,1,10,10,-1,-10,40
105,33,3,2897,10,40,30,10,1,-30,30,1,10,60
105,34,4,2620,-40,20,60,40,1,20,20,-0.5,-50,40
105,35,5,3721,0,80,80,0,1,40,40,,,40
105,36,6,2935,40,80,40,40,1,-20,20,0.5,50,60
105,37,7,3755,40,100,60,40,1,0,0,-0.75,50,60
105,38,8,2568,-80,0,80,80,1,40,40,0.25,-70,40
105,39,9,3459,30,60,30,30,1,-30,30,0.333333333,30,60
105,40,10,2645,20,60,40,20,1,-20,20,0.5,10,60
105,41,11,2384,0,60,60,0,1,20,20,,,40
105,42,12,4569,-10,40,50,10,1,10,10,-1,-10,40
105,43,13,3713,50,100,50,50,1,-10,10,-0.4,50,60
105,44,14,3233,-60,0,60,60,1,20,20,0.166666667,-50,40
105,45,15,5416,10,40,30,10,1,-30,30,-1,10,60
105,46,16,2513,-30,20,50,30,1,10,10,-0.666666667,-30,40
105,47,17,3832,60,80,20,60,1,-40,40,0.166666667,50,60
105,48,18,3655,-10,20,30,10,1,-30,30,1,-10,60
105,49,19,3448,10,80,70,10,1,30,30,-2,10,40
105,50,20,3529,30,80,50,30,1,10,10,0.666666667,30,40
105,51,21,3649,20,40,20,20,1,-40,40,3,10,60
105,52,22,2953,-20,60,80,20,1,20,20,1,-10,60
105,53,23,2649,-10,60,70,10,1,30,30,1,-10,40
105,54,24,3721,40,100,60,40,1,0,0,0,50,60
105,55,25,3254,-40,20,60,40,1,20,20,1,-50,40
105,56,26,4151,-40,20,60,40,1,0,0,0.75,-50,60
105,57,27,4232,-20,0,20,20,1,-20,20,-2,-10,40
105,58,28,3722,-20,40,60,20,1,20,20,,-10,40
105,59,29,3072,50,80,30,50,1,-30,30,,50,60
106,0,0,5653,20,80,60,20,0,0,0,1,10,60
106,1,1,3600,-60,20,80,60,0,40,40,0.5,-50,40
106,2,2,4004,0,50,50,0,0,10,10,,,40
106,3,3,4399,-20,60,80,20,0,20,20,1.5,-10,60
106,4,4,3092,0,50,50,0,0,-10,10,,,60
106,5,5,3422,-20,60,80,20,0,40,40,2,-10,40
106,6,6,2744,0,40,40,0,0,0,0,,,40
106,7,7,2940,10,70,60,10,0,0,0,0,10,60
106,8,8,3066,-20,30,50,20,0,10,10,0,-10,40
106,9,9,2800,-20,40,60,20,0,0,0,0,-10,60
106,10,10,2904,-30,20,50,30,0,10,10,1,-30,40
106,11,11,2837,0,60,60,0,0,0,0,,,60
106,12,12,2779,-20,50,70,20,0,10,10,0,-10,60
106,13,13,2631,10,30,20,10,0,-20,20,2,10,40
106,14,14,3012,0,70,70,0,0,10,10,,,60
106,15,15,2559,20,60,40,20,0,0,0,-0.5,10,40
106,16,16,2875,20,80,60,20,0,0,0,0,10,60
106,17,17,2644,20,50,30,20,0,-10,10,0.5,10,40
106,18,18,2783,-20,40,60,20,0,0,0,0,-10,60
106,19,19,2721,0,40,40,0,0,0,0,,,40
106,20,20,2821,10,70,60,10,0,0,0,-3,10,60
106,21,21,2832,30,60,30,30,0,-30,30,1,30,60
106,22,22,2760,-30,50,80,30,0,40,40,1,-30,40
106,23,23,2809,-30,20,50,30,0,10,10,-0.333333333,-30,40
106,24,24,2927,20,80,60,20,0,0,0,0,10,60
106,25,25,3013,-20,40,60,20,0,20,20,1,-10,40
106,26,26,2676,20,60,40,20,0,0,0,2,10,40
106,27,27,2659,-10,50,60,10,0,0,0,1,-10,60
106,28,28,2891,-10,40,50,10,0,-10,10,,-10,60
106,29,29,3042,-50,30,80,50,0,40,40,,-50,40
106,30,0,5327,-50,0,50,50,1,10,10,0,-50,40
106,31,1,2801,20,40,20,20,1,-40,40,1.5,10,60
106,32,2,2765,30,80,50,30,1,10,10,-0.666666667,30,40
106,33,3,3234,-30,20,50,30,1,-10,10,1.333333333,-30,60
106,34,4,2774,30,60,30,30,1,-10,10,1,30,40
106,35,5,2850,-20,40,60,20,1,20,20,1.5,-10,40
106,36,6,3231,70,80,10,70,1,-50,50,0.571428571,70,60
106,37,7,2850,50,100,50,50,1,-10,10,-0.4,50,60
106,38,8,3567,-10,20,30,10,1,-10,10,0,-10,40
106,39,9,2795,30,60,30,30,1,-30,30,0,30,60
106,40,10,2654,30,60,30,30,1,-30,30,0.333333333,30,60
106,41,11,3161,30,60,30,30,1,-10,10,1,30,40
106,42,12,2905,20,80,60,20,1,20,20,-1.5,10,40
106,43,13,2675,60,100,40,60,1,-20,20,0,50,60
106,44,14,2910,10,40,30,10,1,-10,10,2,10,40
106,45,15,2713,-20,20,40,20,1,-20,20,1,-10,60
106,46,16,2694,-50,0,50,50,1,10,10,-0.2,-50,40
106,47,17,2724,20,40,20,20,1,-40,40,1.5,10,60
106,48,18,3265,30,80,50,30,1,-10,10,0,30,60
106,49,19,2810,-40,20,60,40,1,20,20,0.5,-50,40
106,50,20,3085,-20,20,40,20,1,0,0,-2,-10,40
106,51,21,3527,10,60,50,10,1,-10,10,-2,10,60
106,52,22,2647,70,100,30,70,1,-30,30,0.142857143,70,60
106,53,23,2977,-80,0,80,80,1,40,40,1,-70,40
106,54,24,2697,-20,20,40,20,1,-20,20,1,-10,60
106,55,25,2860,60,60,0,60,1,-40,40,1,50,40
106,56,26,3269,20,40,20,20,1,-40,40,0.5,10,60
106,57,27,2865,-20,40,60,20,1,20,20,1,-10,40
106,58,28,3085,40,80,40,40,1,0,0,,50,40
106,59,29,3214,50,80,30,50,1,-30,30,,50,60
107,0,0,4192,-20,60,80,20,1,40,40,0.5,-10,40
107,1,1,3342,90,100,10,90,1,-50,50,0,70,60
107,2,2,3599,-50,20,70,50,1,30,30,0.2,-50,40
107,3,3,3461,10,20,10,10,1,-50,50,7,10,60
107,4,4,3111,20,80,60,20,1,20,20,-1.5,10,40
107,5,5,3129,-30,0,30,30,1,-10,10,-2,-30,40
107,6,6,4561,0,80,80,0,1,20,20,,,60
107,7,7,2976,-30,40,70,30,1,10,10,1.333333333,-30,60
107,8,8,3623,-50,40,90,50,1,50,50,1,-50,40
107,9,9,3918,30,60,30,30,1,-30,30,0.333333333,30,60
107,10,10,4000,0,40,40,0,1,-20,20,,,60
107,11,11,2839,-40,0,40,40,1,0,0,-0.25,-50,40
107,12,12,3271,-10,40,50,10,1,10,10,0,-10,40
107,13,13,3391,-30,20,50,30,1,-10,10,-0.666666667,-30,60
107,14,14,3400,-30,20,50,30,1,10,10,-1,-30,40
107,15,15,3073,30,100,70,30,1,10,10,-1.333333333,30,60
107,16,16,3392,-20,60,80,20,1,40,40,3,-10,40
107,17,17,3519,50,80,30,50,1,-30,30,0,50,60
107,18,18,4040,30,60,30,30,1,-30,30,0,30,60
107,19,19,3753,60,80,20,60,1,-20,20,0.666666667,50,40
107,20,20,3951,-60,0,60,60,1,20,20,-0.166666667,-50,40
107,21,21,3952,50,80,30,50,1,-30,30,0.6,50,60
107,22,22,3465,40,100,60,40,1,0,0,-1,50,60
107,23,23,3607,-10,60,70,10,1,30,30,4,-10,40
107,24,24,3087,40,60,20,40,1,-40,40,1.5,50,60
107,25,25,3176,10,40,30,10,1,-10,10,-1,10,40
107,26,26,3009,-40,40,80,40,1,20,20,0.25,-50,60
107,27,27,3414,60,80,20,60,1,-20,20,0.833333333,50,40
107,28,28,3248,-50,20,70,50,1,30,30,,-50,40
107,29,29,3178,-50,20,70,50,1,10,10,,-50,60
107,30,0,4371,20,80,60,20,0,0,0,1,10,60
107,31,1,3736,-60,20,80,60,0,40,40,1.333333333,-50,40
107,32,2,3261,50,50,0,50,0,-40,40,1.4,50,40
107,33,3,2983,-10,70,80,10,0,20,20,1,-10,60
107,34,4,3760,-30,40,70,30,0,10,10,0,-30,60
107,35,5,3176,-40,30,70,40,0,30,30,1,-50,40
107,36,6,3894,10,40,30,10,0,-10,10,0,10,40
107,37,7,3503,-20,50,70,20,0,10,10,-1,-10,60
107,38,8,3760,30,60,30,30,0,-10,10,-0.333333333,30,40
107,39,9,3078,-30,60,90,30,0,30,30,1.333333333,-30,60
107,40,10,3656,40,60,20,40,0,-20,20,0.75,50,40
107,41,11,3997,10,60,50,10,0,-10,10,3,10,60
107,42,12,3783,-40,40,80,40,0,20,20,0.75,-50,60
107,43,13,3783,-30,20,50,30,0,10,10,-0.333333333,-30,40
107,44,14,2863,30,80,50,30,0,-10,10,-0.333333333,30,60
107,45,15,3071,-30,30,60,30,0,20,20,0.333333333,-30,40
107,46,16,3350,10,50,40,10,0,-20,20,-1,10,60
107,47,17,4215,0,50,50,0,0,10,10,,,40
107,48,18,3527,40,70,30,40,0,-30,30,1,50,60
107,49,19,3839,10,40,30,10,0,-10,10,2,10,40
107,50,20,3680,0,70,70,0,0,10,10,,,60
107,51,21,3519,40,60,20,40,0,-40,40,1.25,50,60
107,52,22,3951,-30,20,50,30,0,10,10,0.333333333,-30,40
107,53,23,4405,20,60,40,20,0,0,0,0.5,10,40
107,54,24,3046,10,80,70,10,0,10,10,-3,10,60
107,55,25,5429,0,50,50,0,0,10,10,,,40
107,56,26,3270,10,30,20,10,0,-20,20,4,10,40
107,57,27,5087,10,50,40,10,0,-20,20,4,10,60
107,58,28,3190,-40,40,80,40,0,20,20,,-50,60
107,59,29,4431,-20,40,60,20,0,20,20,,-10,40
108,0,0,4398,-70,20,90,70,1,50,50,0.857142857,-70,40
108,1,1,4588,10,80,70,10,1,10,10,-4,10,60
108,2,2,4495,50,80,30,50,1,-10,10,0.4,50,40
108,3,3,4509,10,40,30,10,1,-30,30,0,10,60
108,4,4,4652,-10,40,50,10,1,10,10,-3.5,-10,40
108,5,5,4420,-85,0,85,85,1,45,45,0.529411765,-70,40
108,6,6,4972,30,60,30,30,1,-30,30,1.333333333,30,60
108,7,7,4461,-50,20,70,50,1,10,10,-0.2,-50,60
108,8,8,4875,20,60,40,20,1,0,0,0,10,40
108,9,9,4269,20,100,80,20,1,20,20,0,10,60
108,10,10,4672,0,80,80,0,1,20,20,,,60
108,11,11,4699,-40,0,40,40,1,0,0,-1,-50,40
108,12,12,4248,-20,60,80,20,1,40,40,3,-10,40
108,13,13,4333,20,60,40,20,1,-20,20,0.5,10,60
108,14,14,3833,60,80,20,60,1,-20,20,1.166666667,50,40
108,15,15,4013,-30,20,50,30,1,-10,10,-1.333333333,-30,60
108,16,16,4472,-70,20,90,70,1,50,50,0.857142857,-70,40
108,17,17,3654,-50,40,90,50,1,30,30,1,-50,60
108,18,18,3763,60,100,40,60,1,-20,20,0.5,50,60
108,19,19,4013,10,40,30,10,1,-10,10,0,10,40
108,20,20,4356,-30,0,30,30,1,-10,10,-1,-30,40
108,21,21,4079,30,100,70,30,1,10,10,,30,60
108,22,22,7010,,60,,,1,,,,,60
108,23,23,5455,-20,40,60,20,1,20,20,-0.5,-10,40
108,24,24,7004,,20,,,1,,,,,60
108,25,25,3854,-50,20,70,50,1,30,30,0.8,-50,40
108,26,26,4712,-10,80,90,10,1,30,30,1,-10,60
108,27,27,4050,50,80,30,50,1,-10,10,0,50,40
108,28,28,4470,30,60,30,30,1,-10,10,,30,40
108,29,29,5803,-40,40,80,40,1,20,20,,-50,60
108,30,0,6059,-20,80,100,20,0,40,40,0.5,-10,60
108,31,1,4209,-30,20,50,30,0,10,10,0.333333333,-30,40
108,32,2,3221,0,40,40,0,0,0,0,,,40
108,33,3,3261,-20,70,90,20,0,30,30,0,-10,60
108,34,4,3637,-30,60,90,30,0,30,30,2,-30,60
108,35,5,3948,20,60,40,20,0,0,0,0,10,40
108,36,6,4372,-10,30,40,10,0,0,0,-4,-10,40
108,37,7,3380,20,50,30,20,0,-30,30,3,10,60
108,38,8,4198,-30,50,80,30,0,40,40,1.333333333,-30,40
108,39,9,3648,-50,40,90,50,0,30,30,0,-50,60
108,40,10,3330,20,60,40,20,0,0,0,1.5,10,40
108,41,11,3989,-20,70,90,20,0,30,30,0.5,-10,60
108,42,12,5497,-20,60,80,20,0,20,20,1,-10,60
108,43,13,3575,-50,20,70,50,0,30,30,-0.2,-50,40
108,44,14,3769,-20,40,60,20,0,0,0,-1,-10,60
108,45,15,5487,-40,40,80,40,0,40,40,1,-50,40
108,46,16,4642,-30,50,80,30,0,20,20,-0.333333333,-30,60
108,47,17,3258,10,50,40,10,0,0,0,1,10,40
108,48,18,3760,-10,80,90,10,0,30,30,0,-10,60
108,49,19,4055,-20,30,50,20,0,10,10,0,-10,40
108,50,20,3823,-10,80,90,10,0,30,30,1,-10,60
108,51,21,3885,-30,50,80,30,0,20,20,0.333333333,-30,60
108,52,22,3981,-10,40,50,10,0,10,10,1,-10,40
108,53,23,4387,10,50,40,10,0,0,0,0,10,40
108,54,24,4339,-10,60,70,10,0,10,10,1,-10,60
108,55,25,3612,-20,20,40,20,0,0,0,-0.5,-10,40
108,56,26,3963,10,60,50,10,0,10,10,1,10,40
108,57,27,4168,-20,40,60,20,0,0,0,0,-10,60
108,58,28,4079,10,70,60,10,0,0,0,,10,60
108,59,29,4106,-30,30,60,30,0,20,20,,-30,40
109,0,0,3594,0,40,40,0,0,-20,20,,,60
109,1,1,3332,-10,60,70,10,0,30,30,1,-10,40
109,2,2,3921,-40,20,60,40,0,20,20,0.5,-50,40
109,3,3,3272,10,60,50,10,0,-10,10,2,10,60
109,4,4,3337,-20,50,70,20,0,10,10,-0.5,-10,60
109,5,5,3409,-10,30,40,10,0,0,0,0,-10,40
109,6,6,4447,10,50,40,10,0,0,0,-2,10,40
109,7,7,3506,-10,70,80,10,0,20,20,0,-10,60
109,8,8,3376,20,40,20,20,0,-20,20,0.5,10,40
109,9,9,3546,0,80,80,0,0,20,20,,,60
109,10,10,3478,20,50,30,20,0,-10,10,1,10,40
109,11,11,3498,-30,40,70,30,0,10,10,-0.333333333,-30,60
109,12,12,3355,0,80,80,0,0,20,20,,,60
109,13,13,3610,-10,40,50,10,0,10,10,2,-10,40
109,14,14,3330,10,70,60,10,0,0,0,1,10,60
109,15,15,3872,-10,20,30,10,0,-10,10,-1,-10,40
109,16,16,3285,-20,50,70,20,0,10,10,-0.5,-10,60
109,17,17,3804,20,60,40,20,0,0,0,-0.5,10,40
109,18,18,3670,-20,60,80,20,0,20,20,-0.5,-10,60
109,19,19,3352,0,30,30,0,0,-10,10,,,40
109,20,20,3379,-20,70,90,20,0,30,30,1.5,-10,60
109,21,21,3952,-10,50,60,10,0,0,0,-2,-10,60
109,22,22,3523,10,50,40,10,0,0,0,-1,10,40
109,23,23,3425,10,40,30,10,0,-10,10,-1,10,40
109,24,24,3259,0,80,80,0,0,20,20,,,60
109,25,25,3282,0,20,20,0,0,-20,20,,,40
109,26,26,3304,-20,30,50,20,0,10,10,0.5,-10,40
109,27,27,3120,0,60,60,0,0,0,0,,,60
109,28,28,3552,-50,40,90,50,0,30,30,,-50,60
109,29,29,3290,20,60,40,20,0,0,0,,10,40
109,30,0,3765,-40,0,40,40,1,0,0,0.75,-50,40
109,31,1,4270,20,100,80,20,1,20,20,0,10,60
109,32,2,3368,30,40,10,30,1,-30,30,1.333333333,30,40
109,33,3,3282,-60,20,80,60,1,20,20,0.333333333,-50,60
109,34,4,3440,-30,20,50,30,1,10,10,1,-30,40
109,35,5,3364,60,80,20,60,1,-20,20,0.333333333,50,40
109,36,6,3160,0,60,60,0,1,0,0,,,60
109,37,7,3593,-10,40,50,10,1,-10,10,-1,-10,60
109,38,8,4080,20,60,40,20,1,0,0,-0.5,10,40
109,39,9,4164,20,80,60,20,1,0,0,0.5,10,60
109,40,10,3514,30,100,70,30,1,10,10,0,30,60
109,41,11,4247,30,60,30,30,1,-10,10,0.333333333,30,40
109,42,12,3409,40,80,40,40,1,0,0,-0.25,50,40
109,43,13,3415,-30,40,70,30,1,10,10,0,-30,60
109,44,14,4263,10,40,30,10,1,-10,10,0,10,40
109,45,15,3927,-50,20,70,50,1,10,10,-0.2,-50,60
109,46,16,3546,-10,20,30,10,1,-10,10,-3,-10,40
109,47,17,3887,0,80,80,0,1,20,20,,,60
109,48,18,5674,0,60,60,0,1,0,0,,,60
109,49,19,3908,-60,0,60,60,1,20,20,0.5,-50,40
109,50,20,3872,-10,20,30,10,1,-10,10,0,-10,40
109,51,21,3768,20,100,80,20,1,20,20,-0.5,10,60
109,52,22,4535,-30,40,70,30,1,10,10,0,-30,60
109,53,23,3657,10,40,30,10,1,-10,10,-1,10,40
109,54,24,3823,-10,60,70,10,1,10,10,0,-10,60
109,55,25,3338,40,60,20,40,1,-20,20,-0.25,50,40
109,56,26,3831,10,80,70,10,1,10,10,-1,10,60
109,57,27,4715,70,80,10,70,1,-30,30,0.571428571,70,40
109,58,28,4461,-50,0,50,50,1,10,10,,-50,40
109,59,29,3751,-40,20,60,40,1,0,0,,-50,60
110,0,0,4954,-30,50,80,30,0,20,20,0.666666667,-30,60
110,1,1,4075,0,20,20,0,0,-20,20,,,40
110,2,2,3873,0,40,40,0,0,0,0,,,40
110,3,3,3926,10,70,60,10,0,0,0,-2,10,60
110,4,4,3705,20,60,40,20,0,-20,20,1.5,10,60
110,5,5,4567,20,50,30,20,0,-10,10,0.5,10,40
110,6,6,3750,-10,30,40,10,0,0,0,0,-10,40
110,7,7,3727,10,80,70,10,0,10,10,-2,10,60
110,8,8,4517,20,60,40,20,0,0,0,-1,10,40
110,9,9,5184,-10,40,50,10,0,-10,10,-1,-10,60
110,10,10,3638,40,60,20,40,0,-20,20,0,50,40
110,11,11,4120,-20,40,60,20,0,0,0,0,-10,60
110,12,12,3801,-10,50,60,10,0,0,0,2,-10,60
110,13,13,3649,0,20,20,0,0,-20,20,,,40
110,14,14,3868,30,70,40,30,0,-20,20,1.333333333,30,60
110,15,15,4424,0,30,30,0,0,-10,10,,,40
110,16,16,3484,-20,60,80,20,0,20,20,1.5,-10,60
110,17,17,3892,20,50,30,20,0,-10,10,-0.5,10,40
110,18,18,4079,30,80,50,30,0,-10,10,0.333333333,30,60
110,19,19,4002,20,40,20,20,0,-20,20,0,10,40
110,20,20,3327,10,70,60,10,0,0,0,-1,10,60
110,21,21,4888,-10,40,50,10,0,-10,10,1,-10,60
110,22,22,3286,30,50,20,30,0,-20,20,0.333333333,30,40
110,23,23,4224,30,60,30,30,0,-10,10,0,30,40
110,24,24,3634,20,60,40,20,0,-20,20,2,10,60
110,25,25,3618,10,40,30,10,0,-10,10,-1,10,40
110,26,26,3784,10,30,20,10,0,-20,20,2,10,40
110,27,27,4239,0,80,80,0,0,20,20,,,60
110,28,28,3539,-20,50,70,20,0,10,10,,-10,60
110,29,29,3610,-20,20,40,20,0,0,0,,-10,40
110,30,0,4489,-30,20,50,30,1,10,10,0.333333333,-30,40
110,31,1,3936,10,40,30,10,1,-30,30,0,10,60
110,32,2,3545,40,80,40,40,1,0,0,0.25,50,40
110,33,3,4775,-10,20,30,10,1,-30,30,0,-10,60
110,34,4,3608,10,60,50,10,1,10,10,0,10,40
110,35,5,4758,-10,40,50,10,1,10,10,0,-10,40
110,36,6,3639,50,80,30,50,1,-30,30,0.2,50,60
110,37,7,3753,60,100,40,60,1,-20,20,-0.166666667,50,60
110,38,8,3623,-50,0,50,50,1,10,10,0.2,-50,40
110,39,9,3891,30,60,30,30,1,-30,30,0.333333333,30,60
110,40,10,3455,-20,20,40,20,1,-20,20,0,-10,60
110,41,11,3324,0,40,40,0,1,0,0,,,40
110,42,12,3603,30,80,50,30,1,10,10,-1.666666667,30,40
110,43,13,5027,60,100,40,60,1,-20,20,0.333333333,50,60
110,44,14,3467,0,0,0,0,1,-40,40,,,40
110,45,15,3716,0,60,60,0,1,0,0,,,60
110,46,16,3785,-10,20,30,10,1,-10,10,1,-10,40
110,47,17,6476,50,80,30,50,1,-30,30,0.6,50,60
110,48,18,3856,-20,40,60,20,1,0,0,2,-10,60
110,49,19,4860,40,60,20,40,1,-20,20,1.5,50,40
110,50,20,3333,-40,40,80,40,1,40,40,1,-50,40
110,51,21,5379,40,60,20,40,1,-40,40,0.25,50,60
110,52,22,3554,-10,20,30,10,1,-30,30,-2,-10,60
110,53,23,4594,20,60,40,20,1,0,0,-2,10,40
110,54,24,4675,50,100,50,50,1,-10,10,-0.2,50,60
110,55,25,3587,80,80,0,80,1,-40,40,0.25,70,40
110,56,26,4325,40,80,40,40,1,-20,20,0,50,60
110,57,27,3952,0,20,20,0,1,-20,20,,,40
110,58,28,4392,-30,0,30,30,1,-10,10,,-30,40
110,59,29,3992,0,40,40,0,1,-20,20,,,60
111,0,0,7039,30,80,50,30,1,10,10,0.666666667,30,40
111,1,1,5499,0,40,40,0,1,-20,20,,,60
111,2,2,5315,-70,0,70,70,1,30,30,0,-70,40
111,3,3,5120,10,60,50,10,1,-10,10,1,10,60
111,4,4,4829,-10,60,70,10,1,30,30,2,-10,40
111,5,5,4101,-10,40,50,10,1,10,10,-4,-10,40
111,6,6,4894,40,100,60,40,1,0,0,0,50,60
111,7,7,4827,20,80,60,20,1,0,0,0.5,10,60
111,8,8,3973,-70,20,90,70,1,50,50,0.285714286,-70,40
111,9,9,4028,-50,20,70,50,1,10,10,0.6,-50,60
111,10,10,4332,-20,20,40,20,1,-20,20,-2.5,-10,60
111,11,11,4291,-70,0,70,70,1,30,30,0.285714286,-70,40
111,12,12,6980,30,80,50,30,1,10,10,0,30,40
111,13,13,4220,-50,40,90,50,1,30,30,0.8,-50,60
111,14,14,4131,10,60,50,10,1,10,10,1,10,40
111,15,15,4252,50,100,50,50,1,-10,10,0.4,50,60
111,16,16,3291,-20,40,60,20,1,20,20,0,-10,40
111,17,17,3852,10,80,70,10,1,10,10,-2,10,60
111,18,18,4564,10,60,50,10,1,-10,10,0,10,60
111,19,19,4417,-40,20,60,40,1,20,20,0.5,-50,40
111,20,20,3390,40,80,40,40,1,0,0,0.5,50,40
111,21,21,4293,30,80,50,30,1,-10,10,-0.333333333,30,60
111,22,22,3950,0,40,40,0,1,-20,20,,,60
111,23,23,4050,0,60,60,0,1,20,20,,,40
111,24,24,3467,-20,20,40,20,1,-20,20,0,-10,60
111,25,25,3124,-10,40,50,10,1,10,10,3,-10,40
111,26,26,3802,60,100,40,60,1,-20,20,-0.666666667,50,60
111,27,27,3802,0,20,20,0,1,-20,20,,,40
111,28,28,3403,-30,0,30,30,1,-10,10,,-30,40
111,29,29,2779,60,60,0,60,1,-60,60,,50,60
111,30,0,4742,0,60,60,0,0,0,0,,,60
111,31,1,4252,-10,40,50,10,0,10,10,1,-10,40
111,32,2,3850,10,50,40,10,0,0,0,1,10,40
111,33,3,4946,20,80,60,20,0,0,0,1,10,60
111,34,4,3835,-10,70,80,10,0,20,20,4,-10,60
111,35,5,4299,-30,20,50,30,0,10,10,-0.333333333,-30,40
111,36,6,3910,-30,30,60,30,0,20,20,0.333333333,-30,40
111,37,7,5370,0,40,40,0,0,-20,20,,,60
111,38,8,4887,10,60,50,10,0,10,10,2,10,40
111,39,9,4997,-10,50,60,10,0,0,0,0,-10,60
111,40,10,6513,-20,50,70,20,0,30,30,0,-10,40
111,41,11,5040,10,70,60,10,0,0,0,2,10,60
111,42,12,3953,-30,50,80,30,0,20,20,1.333333333,-30,60
111,43,13,4057,-30,40,70,30,0,30,30,0.333333333,-30,40
111,44,14,3709,40,80,40,40,0,-20,20,0.5,50,60
111,45,15,3728,-40,20,60,40,0,20,20,1.5,-50,40
111,46,16,4354,-20,40,60,20,0,0,0,-1,-10,60
111,47,17,2746,60,60,0,60,0,-40,40,1,50,40
111,48,18,4976,-20,60,80,20,0,20,20,0.5,-10,60
111,49,19,4274,-30,30,60,30,0,20,20,-0.333333333,-30,40
111,50,20,4315,10,80,70,10,0,10,10,-3,10,60
111,51,21,3065,10,50,40,10,0,-20,20,2,10,60
111,52,22,4195,-40,30,70,40,0,30,30,-0.25,-50,40
111,53,23,3213,-20,60,80,20,0,40,40,1.5,-10,40
111,54,24,4066,0,60,60,0,0,0,0,,,60
111,55,25,3420,-10,40,50,10,0,10,10,-1,-10,40
111,56,26,3778,-10,50,60,10,0,20,20,2,-10,40
111,57,27,4087,10,70,60,10,0,0,0,3,10,60
111,58,28,4418,-50,40,90,50,0,30,30,,-50,60
111,59,29,3818,-20,20,40,20,0,0,0,,-10,40
112,0,0,4847,30,80,50,30,0,-10,10,0.666666667,30,60
112,1,1,5105,20,50,30,20,0,-10,10,1,10,40
112,2,2,4304,10,60,50,10,0,10,10,0,10,40
112,3,3,4315,-20,50,70,20,0,10,10,0,-10,60
112,4,4,4880,0,70,70,0,0,10,10,,,60
112,5,5,4250,-10,40,50,10,0,10,10,3,-10,40
112,6,6,4393,10,30,20,10,0,-20,20,1,10,40
112,7,7,4168,10,60,50,10,0,-10,10,0,10,60
112,8,8,4409,-10,20,30,10,0,-10,10,-0.5,-10,40
112,9,9,4376,-10,40,50,10,0,-10,10,-2.6,-10,60
112,10,10,4456,-5,30,35,5,0,-5,5,-1,-10,40
112,11,11,4296,-6,70,76,6,0,16,16,2.666666667,-10,60
112,12,12,3885,-10,50,60,10,0,0,0,1,-10,60
112,13,13,4554,20,60,40,20,0,0,0,0,10,40
112,14,14,4134,10,60,50,10,0,-10,10,3,10,60
112,15,15,4688,10,50,40,10,0,0,0,-2,10,40
112,16,16,4248,0,80,80,0,0,20,20,,,60
112,17,17,4778,0,20,20,0,0,-20,20,,,40
112,18,18,5792,-40,40,80,40,0,20,20,0.25,-50,60
112,19,19,4533,0,40,40,0,0,0,0,,,40
112,20,20,4143,0,70,70,0,0,10,10,,,60
112,21,21,4280,0,80,80,0,0,20,20,,,60
112,22,22,4321,20,60,40,20,0,0,0,-1,10,40
112,23,23,3808,30,50,20,30,0,-20,20,1,30,40
112,24,24,4545,0,50,50,0,0,-10,10,,,60
112,25,25,3905,-20,30,50,20,0,10,10,1,-10,40
112,26,26,3813,-10,20,30,10,0,-10,10,1,-10,40
112,27,27,4632,-40,40,80,40,0,20,20,0.5,-50,60
112,28,28,4768,0,60,60,0,0,0,0,,,60
112,29,29,4199,20,40,20,20,0,-20,20,,10,40
112,30,0,5134,20,80,60,20,1,20,20,-1.5,10,40
112,31,1,4708,20,40,20,20,1,-40,40,0,10,60
112,32,2,4161,10,40,30,10,1,-10,10,2,10,40
112,33,3,4512,60,80,20,60,1,-40,40,0.333333333,50,60
112,34,4,4680,-50,0,50,50,1,10,10,0.6,-50,40
112,35,5,5320,0,20,20,0,1,-20,20,,,40
112,36,6,3680,60,100,40,60,1,-20,20,0.833333333,50,60
112,37,7,4601,-70,20,90,70,1,30,30,-0.142857143,-70,60
112,38,8,3914,40,60,20,40,1,-20,20,0.25,50,40
112,39,9,4824,-40,60,100,40,1,40,40,1.5,-50,60
112,40,10,3714,40,80,40,40,1,-20,20,-0.25,50,60
112,41,11,3976,-30,0,30,30,1,-10,10,-1,-30,40
112,42,12,5447,20,80,60,20,1,20,20,-1,10,40
112,43,13,4134,10,40,30,10,1,-30,30,3,10,60
112,44,14,3656,0,40,40,0,1,0,0,,,40
112,45,15,4032,40,100,60,40,1,0,0,-1,50,60
112,46,16,5400,20,60,40,20,1,0,0,0,10,40
112,47,17,3568,40,60,20,40,1,-40,40,1,50,60
112,48,18,3568,-40,20,60,40,1,0,0,0.5,-50,60
112,49,19,3867,-20,20,40,20,1,0,0,-0.5,-10,40
112,50,20,4086,-10,40,50,10,1,10,10,0,-10,40
112,51,21,3841,60,100,40,60,1,-20,20,0.333333333,50,60
112,52,22,3679,-40,20,60,40,1,0,0,-1,-50,60
112,53,23,4232,30,80,50,30,1,10,10,-0.333333333,30,40
112,54,24,4760,-20,80,100,20,1,40,40,1,-10,60
112,55,25,4273,20,60,40,20,1,0,0,0,10,40
112,56,26,3399,-20,60,80,20,1,20,20,1,-10,60
112,57,27,3526,-40,0,40,40,1,0,0,0.5,-50,40
112,58,28,4016,0,20,20,0,1,-20,20,,,40
112,59,29,4400,-20,40,60,20,1,0,0,,-10,60
113,0,0,4888,20,80,60,20,1,20,20,0.5,10,40
113,1,1,4508,-30,20,50,30,1,-10,10,0,-30,60
113,2,2,4464,-10,60,70,10,1,30,30,0,-10,40
113,3,3,4693,10,60,50,10,1,-10,10,0,10,60
113,4,4,4688,-70,0,70,70,1,30,30,0,-70,40
113,5,5,5919,-30,40,70,30,1,30,30,0.666666667,-30,40
113,6,6,4035,-10,40,50,10,1,-10,10,0,-10,60
113,7,7,3602,50,100,50,50,1,-10,10,0,50,60
113,8,8,4175,-30,20,50,30,1,10,10,0.666666667,-30,40
113,9,9,4413,30,80,50,30,1,-10,10,0.666666667,30,60
113,10,10,4640,30,100,70,30,1,10,10,0,30,60
113,11,11,4251,-10,20,30,10,1,-10,10,0,-10,40
113,12,12,4062,50,80,30,50,1,-10,10,0.2,50,40
113,13,13,3983,10,80,70,10,1,10,10,-2,10,60
113,14,14,5456,20,60,40,20,1,0,0,1,10,40
113,15,15,3745,10,60,50,10,1,-10,10,0,10,60
113,16,16,4045,-20,40,60,20,1,20,20,0.5,-10,40
113,17,17,3546,-30,20,50,30,1,-10,10,0.666666667,-30,60
113,18,18,3870,10,40,30,10,1,-30,30,2,10,60
113,19,19,3822,-50,0,50,50,1,10,10,0,-50,40
113,20,20,3398,10,60,50,10,1,10,10,0,10,40
113,21,21,4100,50,100,50,50,1,-10,10,-0.2,50,60
113,22,22,4006,0,40,40,0,1,-20,20,,,60
113,23,23,3834,-50,0,50,50,1,10,10,0,-50,40
113,24,24,4799,-10,20,30,10,1,-30,30,0,-10,60
113,25,25,3909,-30,20,50,30,1,10,10,0,-30,40
113,26,26,4372,50,80,30,50,1,-30,30,0.4,50,60
113,27,27,4980,-10,40,50,10,1,10,10,3,-10,40
113,28,28,7004,60,80,20,60,1,-20,20,,50,40
113,29,29,4086,10,60,50,10,1,-10,10,,10,60
113,30,0,4671,20,70,50,20,0,-10,10,0,10,60
113,31,1,4094,0,40,40,0,0,0,0,,,40
113,32,2,3478,10,60,50,10,0,10,10,0,10,40
113,33,3,3854,10,60,50,10,0,-10,10,0,10,60
113,34,4,4892,0,50,50,0,0,-10,10,,,60
113,35,5,3716,-20,30,50,20,0,10,10,0,-10,40
113,36,6,3756,0,50,50,0,0,10,10,,,40
113,37,7,4357,30,80,50,30,0,-10,10,0.333333333,30,60
113,38,8,4041,-30,20,50,30,0,10,10,0,-30,40
113,39,9,3499,-20,40,60,20,0,0,0,0.5,-10,60
113,40,10,3419,-10,40,50,10,0,10,10,1,-10,40
113,41,11,3816,20,70,50,20,0,-10,10,0.5,10,60
113,42,12,4310,-10,50,60,10,0,0,0,1,-10,60
113,43,13,4109,10,50,40,10,0,0,0,1,10,40
113,44,14,3662,30,80,50,30,0,-10,10,0.333333333,30,60
113,45,15,5129,-30,20,50,30,0,10,10,0.333333333,-30,40
113,46,16,4451,0,60,60,0,0,0,0,,,60
113,47,17,3771,20,60,40,20,0,0,0,0.5,10,40
113,48,18,3577,-30,40,70,30,0,10,10,-0.333333333,-30,60
113,49,19,4127,-20,30,50,20,0,10,10,0,-10,40
113,50,20,3559,-40,40,80,40,0,20,20,0.75,-50,60
113,51,21,3332,10,60,50,10,0,-10,10,0,10,60
113,52,22,4109,0,50,50,0,0,10,10,,,40
113,53,23,3951,-30,20,50,30,0,10,10,0,-30,40
113,54,24,4040,30,80,50,30,0,-10,10,0.333333333,30,60
113,55,25,3718,10,60,50,10,0,10,10,1,10,40
113,56,26,4341,-20,40,60,20,0,20,20,0.5,-10,40
113,57,27,4669,-10,50,60,10,0,0,0,0,-10,60
113,58,28,6097,10,70,60,10,0,0,0,,10,60
113,59,29,3765,-20,30,50,20,0,10,10,,-10,40
114,0,0,4500,-25,40,65,25,0,5,5,1,-30,60
114,1,1,4111,-35,30,65,35,0,25,25,0.714285714,-30,40
114,2,2,3855,20,60,40,20,0,0,0,0,10,40
114,3,3,3674,30,70,40,30,0,-20,20,0,30,60
114,4,4,3599,10,50,40,10,0,-20,20,1,10,60
114,5,5,3606,-20,20,40,20,0,0,0,0,-10,40
114,6,6,4024,10,50,40,10,0,0,0,-1.5,10,40
114,7,7,3665,10,60,50,10,0,-10,10,0.5,10,60
114,8,8,3651,15,40,25,15,0,-15,15,0.333333333,10,40
114,9,9,3366,25,80,55,25,0,-5,5,0.4,30,60
114,10,10,3515,0,30,30,0,0,-10,10,,,40
114,11,11,3788,15,80,65,15,0,5,5,-1,10,60
114,12,12,4114,-10,40,50,10,0,-10,10,0,-10,60
114,13,13,3533,15,50,35,15,0,-5,5,0.333333333,10,40
114,14,14,3872,10,60,50,10,0,-10,10,0.5,10,60
114,15,15,3663,-20,20,40,20,0,0,0,0.25,-10,40
114,16,16,3024,15,70,55,15,0,-5,5,1,10,60
114,17,17,3811,25,60,35,25,0,-5,5,0.6,30,40
114,18,18,3669,-20,50,70,20,0,10,10,0,-10,60
114,19,19,3223,-10,40,50,10,0,10,10,2,-10,40
114,20,20,3214,-20,50,70,20,0,10,10,0.5,-10,60
114,21,21,3332,10,70,60,10,0,0,0,-0.6,10,60
114,22,22,3876,30,60,30,30,0,-10,10,0.166666667,30,40
114,23,23,4793,15,50,35,15,0,-5,5,-0.666666667,10,40
114,24,24,3811,26,80,54,26,0,-6,6,-0.346153846,30,60
114,25,25,3970,5,30,25,5,0,-15,15,4,10,40
114,26,26,3112,-25,20,45,25,0,5,5,0,-30,40
114,27,27,3159,-5,40,45,5,0,-15,15,-4.4,-10,60
114,28,28,3334,-7,60,67,7,0,7,7,,-10,60
114,29,29,3286,-5,40,45,5,0,5,5,,-10,40
114,30,0,4805,-40,40,80,40,1,40,40,1,-50,40
114,31,1,3686,60,100,40,60,1,-20,20,0.166666667,50,60
114,32,2,3966,40,80,40,40,1,0,0,0,50,40
114,33,3,2719,-30,20,50,30,1,-10,10,-0.666666667,-30,60
114,34,4,2954,-20,20,40,20,1,0,0,0.5,-10,40
114,35,5,2797,30,60,30,30,1,-10,10,0.333333333,30,40
114,36,6,2626,-10,60,70,10,1,10,10,-1,-10,60
114,37,7,3355,-40,40,80,40,1,20,20,0.5,-50,60
114,38,8,3071,-40,0,40,40,1,0,0,0.25,-50,40
114,39,9,3329,20,80,60,20,1,0,0,0,10,60
114,40,10,3336,-40,20,60,40,1,0,0,0.25,-50,60
114,41,11,3053,-30,0,30,30,1,-10,10,0,-30,40
114,42,12,2846,30,60,30,30,1,-10,10,0.333333333,30,40
114,43,13,2994,50,100,50,50,1,-10,10,0.4,50,60
114,44,14,2974,-20,20,40,20,1,0,0,2,-10,40
114,45,15,2845,-30,40,70,30,1,10,10,0.333333333,-30,60
114,46,16,3344,40,40,0,40,1,-40,40,1,50,40
114,47,17,2688,20,80,60,20,1,0,0,0,10,60
114,48,18,2746,0,60,60,0,1,0,0,,,60
114,49,19,2873,40,80,40,40,1,0,0,0,50,40
114,50,20,2868,40,80,40,40,1,0,0,0,50,40
114,51,21,2900,0,80,80,0,1,20,20,,,60
114,52,22,2862,20,100,80,20,1,20,20,-1.5,10,60
114,53,23,3124,-40,0,40,40,1,0,0,0.25,-50,40
114,54,24,2814,-30,20,50,30,1,-10,10,0,-30,60
114,55,25,3120,30,60,30,30,1,-10,10,0.333333333,30,40
114,56,26,3266,10,60,50,10,1,-10,10,-3,10,60
114,57,27,3321,-20,20,40,20,1,0,0,0,-10,40
114,58,28,3432,0,40,40,0,1,0,0,,,40
114,59,29,3293,20,40,20,20,1,-40,40,,10,60
115,0,0,4557,-50,20,70,50,1,30,30,1,-50,40
115,1,1,5707,-20,60,80,20,1,20,20,1,-10,60
115,2,2,4983,20,40,20,20,1,-20,20,1.5,10,40
115,3,3,4592,-20,40,60,20,1,0,0,-0.5,-10,60
115,4,4,5943,30,80,50,30,1,10,10,-1,30,40
115,5,5,7002,-20,0,20,20,1,-20,20,-0.5,-10,40
115,6,6,7001,10,80,70,10,1,10,10,0,10,60
115,7,7,7001,30,100,70,30,1,10,10,,30,60
115,8,8,7002,30,60,30,30,1,-10,10,0.333333333,30,40
115,9,9,7001,,20,,,1,,,,,60
115,10,10,5413,50,80,30,50,1,-30,30,0.2,50,60
115,11,11,4748,20,60,40,20,1,0,0,0.5,10,40
115,12,12,5052,30,80,50,30,1,10,10,1,30,40
115,13,13,4390,0,40,40,0,1,-20,20,,,60
115,14,14,3691,-40,40,80,40,1,40,40,0.5,-50,40
115,15,15,4515,10,60,50,10,1,-10,10,-1,10,60
115,16,16,4070,-40,20,60,40,1,20,20,0.5,-50,40
115,17,17,4413,-20,20,40,20,1,-20,20,0,-10,60
115,18,18,4490,60,100,40,60,1,-20,20,0.666666667,50,60
115,19,19,4435,-40,0,40,40,1,0,0,0,-50,40
115,20,20,5482,0,40,40,0,1,0,0,,,40
115,21,21,5803,-60,20,80,60,1,20,20,0,-50,60
115,22,22,5196,20,100,80,20,1,20,20,-0.5,10,60
115,23,23,4208,-40,0,40,40,1,0,0,0,-50,40
115,24,24,5833,-30,40,70,30,1,10,10,0.333333333,-30,60
115,25,25,5999,40,80,40,40,1,0,0,0,50,40
115,26,26,4908,0,60,60,0,1,0,0,,,60
115,27,27,5492,-20,20,40,20,1,0,0,0.5,-10,40
115,28,28,4770,30,60,30,30,1,-10,10,,30,40
115,29,29,6904,50,80,30,50,1,-30,30,,50,60
115,30,0,3871,10,50,40,10,0,-20,20,2,10,60
115,31,1,2927,-20,20,40,20,0,0,0,0.5,-10,40
115,32,2,2723,30,60,30,30,0,-10,10,0.333333333,30,40
115,33,3,2478,20,80,60,20,0,0,0,-0.5,10,60
115,34,4,5926,20,70,50,20,0,-10,10,1,10,60
115,35,5,2908,10,50,40,10,0,0,0,0,10,40
115,36,6,2840,-10,30,40,10,0,0,0,0,-10,40
115,37,7,3502,-30,40,70,30,0,10,10,0,-30,60
115,38,8,3363,0,40,40,0,0,0,0,,,40
115,39,9,2644,-10,60,70,10,0,10,10,0,-10,60
115,40,10,2511,20,50,30,20,0,-10,10,0.5,10,40
115,41,11,5462,10,80,70,10,0,10,10,-1,10,60
115,42,12,5734,-20,40,60,20,0,0,0,0,-10,60
115,43,13,2827,0,40,40,0,0,0,0,,,40
115,44,14,2735,10,70,60,10,0,0,0,-2,10,60
115,45,15,7001,,20,,,0,,,,,40
115,46,16,2787,10,50,40,10,0,-20,20,2,10,60
115,47,17,3321,20,60,40,20,0,0,0,0,10,40
115,48,18,4137,0,60,60,0,0,0,0,,,60
115,49,19,3511,-10,30,40,10,0,0,0,0,-10,40
115,50,20,6489,20,80,60,20,0,0,0,1,10,60
115,51,21,3842,-40,40,80,40,0,20,20,1,-50,60
115,52,22,2498,20,60,40,20,0,0,0,0,10,40
115,53,23,3023,-20,20,40,20,0,0,0,-0.5,-10,40
115,54,24,3688,20,60,40,20,0,-20,20,1,10,60
115,55,25,4673,-10,40,50,10,0,10,10,1,-10,40
115,56,26,2991,-10,30,40,10,0,0,0,-2,-10,40
115,57,27,3430,10,70,60,10,0,0,0,2,10,60
115,58,28,5004,-30,50,80,30,0,20,20,,-30,60
115,59,29,5589,-10,50,60,10,0,20,20,,-10,40
116,0,0,5421,10,60,50,10,0,-10,10,4,10,60
116,1,1,5046,10,30,20,10,0,-20,20,2,10,40
116,2,2,4684,20,60,40,20,0,0,0,0,10,40
116,3,3,4199,-20,70,90,20,0,30,30,1.5,-10,60
116,4,4,5543,-20,40,60,20,0,0,0,2.75,-10,60
116,5,5,5329,-20,20,40,20,0,0,0,1,-10,40
116,6,6,5470,20,40,20,20,0,-20,20,0,10,40
116,7,7,7018,45,50,5,45,0,-55,55,1.666666667,50,60
116,8,8,4838,30,50,20,30,0,-20,20,1,30,40
116,9,9,4734,0,80,80,0,0,20,20,,,60
116,10,10,6115,0,50,50,0,0,10,10,,,40
116,11,11,4220,0,60,60,0,0,0,0,,,60
116,12,12,4348,-30,40,70,30,0,10,10,-0.666666667,-30,60
116,13,13,5312,-30,20,50,30,0,10,10,0.333333333,-30,40
116,14,14,4324,-40,50,90,40,0,30,30,0.75,-50,60
116,15,15,4911,0,40,40,0,0,0,0,,,40
116,16,16,4552,20,80,60,20,0,0,0,1.5,10,60
116,17,17,4857,30,60,30,30,0,-10,10,-0.333333333,30,40
116,18,18,3729,-20,70,90,20,0,30,30,2.5,-10,60
116,19,19,5120,10,30,20,10,0,-20,20,0,10,40
116,20,20,4587,30,70,40,30,0,-20,20,1,30,60
116,21,21,4461,-10,60,70,10,0,10,10,1,-10,60
116,22,22,5204,0,20,20,0,0,-20,20,,,40
116,23,23,4308,-10,30,40,10,0,0,0,0,-10,40
116,24,24,4414,-10,50,60,10,0,0,0,0,-10,60
116,25,25,4820,10,50,40,10,0,0,0,-1,10,40
116,26,26,4747,30,60,30,30,0,-10,10,0,30,40
116,27,27,5153,20,80,60,20,0,0,0,0.5,10,60
116,28,28,5289,-30,40,70,30,0,10,10,,-30,60
116,29,29,5604,10,40,30,10,0,-10,10,,10,40
116,30,0,4829,-10,40,50,10,1,10,10,2,-10,40
116,31,1,5541,60,80,20,60,1,-40,40,0.666666667,50,60
116,32,2,4063,-10,20,30,10,1,-10,10,0,-10,40
116,33,3,3915,-20,40,60,20,1,0,0,0.5,-10,60
116,34,4,5523,-30,0,30,30,1,-10,10,0.333333333,-30,40
116,35,5,4453,60,80,20,60,1,-20,20,-0.166666667,50,40
116,36,6,6472,10,60,50,10,1,-10,10,2,10,60
116,37,7,5732,-50,20,70,50,1,10,10,0.2,-50,60
116,38,8,4787,50,60,10,50,1,-30,30,-0.2,50,40
116,39,9,5650,40,100,60,40,1,0,0,-0.75,50,60
116,40,10,4911,-10,20,30,10,1,-30,30,-1,-10,60
116,41,11,4561,40,40,0,40,1,-40,40,0.5,50,40
116,42,12,4562,-20,0,20,20,1,-20,20,0,-10,40
116,43,13,5739,0,40,40,0,1,-20,20,,,60
116,44,14,5626,60,80,20,60,1,-20,20,-0.166666667,50,40
116,45,15,5086,40,80,40,40,1,-20,20,-0.25,50,60
116,46,16,3996,50,60,10,50,1,-30,30,-0.2,50,40
116,47,17,4646,30,60,30,30,1,-30,30,1,30,60
116,48,18,5234,40,100,60,40,1,0,0,0.5,50,60
116,49,19,3932,20,20,0,20,1,-40,40,0,10,40
116,50,20,4285,60,60,0,60,1,-40,40,1,50,40
116,51,21,4351,-20,60,80,20,1,20,20,-1,-10,60
116,52,22,4874,0,100,100,0,1,40,40,,,60
116,53,23,4800,-60,0,60,60,1,20,20,0.666666667,-50,40
116,54,24,4714,-20,20,40,20,1,-20,20,-2,-10,60
116,55,25,4719,20,40,20,20,1,-20,20,0,10,40
116,56,26,3755,0,80,80,0,1,20,20,,,60
116,57,27,4592,60,80,20,60,1,-20,20,-0.166666667,50,40
116,58,28,5361,10,20,10,10,1,-30,30,,10,40
116,59,29,4631,0,40,40,0,1,-20,20,,,60
117,0,0,2796,30,80,50,30,0,-10,10,0.666666667,30,60
117,1,1,2706,-20,20,40,20,0,0,0,0,-10,40
117,2,2,2569,20,60,40,20,0,0,0,0,10,40
117,3,3,2651,-30,40,70,30,0,10,10,0,-30,60
117,4,4,2579,-20,50,70,20,0,10,10,0.5,-10,60
117,5,5,2603,0,40,40,0,0,0,0,,,40
117,6,6,2602,-10,30,40,10,0,0,0,0,-10,40
117,7,7,2627,10,70,60,10,0,0,0,0,10,60
117,8,8,2617,10,50,40,10,0,0,0,0,10,40
117,9,9,2675,0,60,60,0,0,0,0,,,60
117,10,10,2554,-20,20,40,20,0,0,0,0,-10,40
117,11,11,2723,-10,50,60,10,0,0,0,0,-10,60
117,12,12,2643,10,70,60,10,0,0,0,0,10,60
117,13,13,2578,10,50,40,10,0,0,0,0,10,40
117,14,14,2673,0,60,60,0,0,0,0,,,60
117,15,15,2586,-10,30,40,10,0,0,0,1,-10,40
117,16,16,2769,-20,40,60,20,0,0,0,-0.5,-10,60
117,17,17,4291,30,60,30,30,0,-10,10,0.666666667,30,40
117,18,18,2594,10,80,70,10,0,10,10,-1,10,60
117,19,19,2777,-10,40,50,10,0,10,10,1,-10,40
117,20,20,2691,0,60,60,0,0,0,0,,,60
117,21,21,2593,10,80,70,10,0,10,10,-2,10,60
117,22,22,2531,-20,20,40,20,0,0,0,0,-10,40
117,23,23,2786,20,60,40,20,0,0,0,0,10,40
117,24,24,3096,20,70,50,20,0,-10,10,1,10,60
117,25,25,2587,0,40,40,0,0,0,0,,,40
117,26,26,2628,10,50,40,10,0,0,0,0,10,40
117,27,27,2617,-20,50,70,20,0,10,10,0,-10,60
117,28,28,2626,-30,40,70,30,0,10,10,,-30,60
117,29,29,2554,-10,30,40,10,0,0,0,,-10,40
117,30,0,3097,-10,40,50,10,1,10,10,-1,-10,40
117,31,1,2721,-40,20,60,40,1,0,0,0.5,-50,60
117,32,2,2738,0,60,60,0,1,20,20,,,40
117,33,3,2602,60,100,40,60,1,-20,20,0.5,50,60
117,34,4,2642,-40,0,40,40,1,0,0,0.25,-50,40
117,35,5,3034,-10,20,30,10,1,-10,10,-1,-10,40
117,36,6,2641,-30,40,70,30,1,10,10,0.666666667,-30,60
117,37,7,2770,30,80,50,30,1,-10,10,0.333333333,30,60
117,38,8,2539,40,80,40,40,1,0,0,0.25,50,40
117,39,9,3300,0,60,60,0,1,0,0,,,60
117,40,10,2554,-50,20,70,50,1,10,10,0,-50,60
117,41,11,2642,-30,20,50,30,1,10,10,0.333333333,-30,40
117,42,12,2610,-40,0,40,40,1,0,0,0.25,-50,40
117,43,13,2553,10,80,70,10,1,10,10,0,10,60
117,44,14,2603,10,40,30,10,1,-10,10,1,10,40
117,45,15,2515,-10,60,70,10,1,10,10,4,-10,60
117,46,16,2506,20,60,40,20,1,0,0,-0.5,10,40
117,47,17,2650,10,40,30,10,1,-30,30,0,10,60
117,48,18,2626,70,100,30,70,1,-30,30,0.571428571,70,60
117,49,19,3002,50,80,30,50,1,-10,10,0.2,50,40
117,50,20,3147,0,40,40,0,1,0,0,,,40
117,51,21,2499,10,80,70,10,1,10,10,0,10,60
117,52,22,2531,-10,60,70,10,1,10,10,1,-10,60
117,53,23,2521,20,60,40,20,1,0,0,0,10,40
117,54,24,3307,-40,20,60,40,1,0,0,-0.25,-50,60
117,55,25,2515,40,80,40,40,1,0,0,0,50,40
117,56,26,2507,30,100,70,30,1,10,10,0,30,60
117,57,27,2498,-40,0,40,40,1,0,0,0,-50,40
117,58,28,2521,-20,20,40,20,1,0,0,,-10,40
117,59,29,2505,-30,40,70,30,1,10,10,,-30,60
118,0,0,4805,30,80,50,30,0,-10,10,1.333333333,30,60
118,1,1,4788,-10,20,30,10,0,-10,10,-3,-10,40
118,2,2,4626,-20,40,60,20,0,20,20,1,-10,40
118,3,3,4177,-30,60,90,30,0,30,30,0.333333333,-30,60
118,4,4,4242,-30,50,80,30,0,20,20,1,-30,60
118,5,5,4456,20,60,40,20,0,0,0,1.5,10,40
118,6,6,4351,-40,30,70,40,0,30,30,0.25,-50,40
118,7,7,6290,-10,40,50,10,0,-10,10,2,-10,60
118,8,8,4972,-10,50,60,10,0,20,20,1,-10,40
118,9,9,4342,40,70,30,40,0,-30,30,1,50,60
118,10,10,5322,-20,30,50,20,0,10,10,0,-10,40
118,11,11,4915,-20,50,70,20,0,10,10,-0.5,-10,60
118,12,12,6108,-40,40,80,40,0,20,20,0.5,-50,60
118,13,13,5077,0,50,50,0,0,10,10,,,40
118,14,14,5068,0,60,60,0,0,0,0,,,60
118,15,15,4972,20,60,40,20,0,0,0,0.5,10,40
118,16,16,5896,10,80,70,10,0,10,10,-1,10,60
118,17,17,6224,-10,40,50,10,0,10,10,3,-10,40
118,18,18,4742,10,70,60,10,0,0,0,2,10,60
118,19,19,5865,0,20,20,0,0,-20,20,,,40
118,20,20,6101,-30,50,80,30,0,20,20,-0.333333333,-30,60
118,21,21,5352,-50,40,90,50,0,30,30,0.6,-50,60
118,22,22,5679,0,50,50,0,0,10,10,,,40
118,23,23,5018,0,40,40,0,0,0,0,,,40
118,24,24,4943,20,80,60,20,0,0,0,0.5,10,60
118,25,25,5235,-10,30,40,10,0,0,0,2,-10,40
118,26,26,6638,0,20,20,0,0,-20,20,,,40
118,27,27,6360,0,70,70,0,0,10,10,,,60
118,28,28,6315,-30,60,90,30,0,30,30,,-30,60
118,29,29,5822,10,60,50,10,0,10,10,,10,40
118,30,0,5250,40,80,40,40,1,0,0,0.5,50,40
118,31,1,4757,30,80,50,30,1,-10,10,-0.333333333,30,60
118,32,2,5216,-40,20,60,40,1,20,20,0.75,-50,40
118,33,3,4614,-20,20,40,20,1,-20,20,-2,-10,60
118,34,4,5666,30,60,30,30,1,-10,10,0.666666667,30,40
118,35,5,6143,-10,40,50,10,1,10,10,2,-10,40
118,36,6,5166,-40,40,80,40,1,20,20,0.75,-50,60
118,37,7,5091,50,100,50,50,1,-10,10,0,50,60
118,38,8,5747,-30,0,30,30,1,-10,10,0.333333333,-30,40
118,39,9,5929,10,60,50,10,1,-10,10,0,10,60
118,40,10,5940,30,80,50,30,1,-10,10,0.333333333,30,60
118,41,11,5287,-20,0,20,20,1,-20,20,-0.5,-10,40
118,42,12,6560,10,40,30,10,1,-10,10,2,10,40
118,43,13,6189,-20,40,60,20,1,0,0,-1,-10,60
118,44,14,6112,30,80,50,30,1,10,10,-0.333333333,30,40
118,45,15,6257,-60,20,80,60,1,20,20,0.666666667,-50,60
118,46,16,6939,-20,20,40,20,1,0,0,0,-10,40
118,47,17,5140,60,100,40,60,1,-20,20,0.5,50,60
118,48,18,5239,-10,60,70,10,1,10,10,1,-10,60
118,49,19,5780,20,60,40,20,1,0,0,-1,10,40
118,50,20,4918,20,40,20,20,1,-20,20,-1,10,40
118,51,21,5489,40,100,60,40,1,0,0,0.75,50,60
118,52,22,5008,-10,80,90,10,1,30,30,3,-10,60
118,53,23,4935,80,80,0,80,1,-40,40,0.5,70,40
118,54,24,5324,-20,40,60,20,1,0,0,-1.5,-10,60
118,55,25,5281,-40,0,40,40,1,0,0,0.5,-50,40
118,56,26,5790,-30,60,90,30,1,30,30,-0.333333333,-30,60
118,57,27,6169,0,20,20,0,1,-20,20,,,40
118,58,28,4533,60,60,0,60,1,-40,40,,50,40
118,59,29,6804,-80,20,100,80,1,40,40,,-70,60
119,0,0,5316,20,80,60,20,0,0,0,1,10,60
119,1,1,3827,-40,20,60,40,0,20,20,1,-50,40
119,2,2,3144,30,50,20,30,0,-20,20,0.5,30,40
119,3,3,4012,-10,70,80,10,0,20,20,0.5,-10,60
119,4,4,3482,-15,60,75,15,0,15,15,0.333333333,-10,60
119,5,5,4753,25,60,35,25,0,-5,5,0.6,30,40
119,6,6,4381,-20,30,50,20,0,10,10,0.5,-10,40
119,7,7,3781,-30,40,70,30,0,10,10,0,-30,60
119,8,8,3395,0,40,40,0,0,0,0,,,40
119,9,9,2996,-20,50,70,20,0,10,10,1,-10,60
119,10,10,3888,0,40,40,0,0,0,0,,,40
119,11,11,3249,-10,40,50,10,0,-10,10,-1,-10,60
119,12,12,4409,0,60,60,0,0,0,0,,,60
119,13,13,2908,20,60,40,20,0,0,0,0,10,40
119,14,14,3076,30,70,40,30,0,-20,20,1,30,60
119,15,15,3006,-10,30,40,10,0,0,0,0,-10,40
119,16,16,2850,10,80,70,10,0,10,10,0,10,60
119,17,17,2991,10,50,40,10,0,0,0,0,10,40
119,18,18,3456,-20,50,70,20,0,10,10,1,-10,60
119,19,19,3015,-20,20,40,20,0,0,0,0,-10,40
119,20,20,3294,10,60,50,10,0,-10,10,1,10,60
119,21,21,3120,10,70,60,10,0,0,0,2,10,60
119,22,22,3142,-10,30,40,10,0,0,0,-1,-10,40
119,23,23,3508,0,50,50,0,0,10,10,,,40
119,24,24,3192,0,80,80,0,0,20,20,,,60
119,25,25,2908,0,40,40,0,0,0,0,,,40
119,26,26,3349,20,60,40,20,0,0,0,-0.5,10,40
119,27,27,3286,-10,50,60,10,0,0,0,-1,-10,60
119,28,28,4002,-30,40,70,30,0,10,10,,-30,60
119,29,29,3527,-10,20,30,10,0,-10,10,,-10,40
119,30,0,4044,40,80,40,40,1,0,0,1,50,40
119,31,1,2983,20,60,40,20,1,-20,20,1,10,60
119,32,2,3103,-40,40,80,40,1,40,40,0.25,-50,40
119,33,3,2908,-20,40,60,20,1,0,0,0.5,-10,60
119,34,4,3163,-50,20,70,50,1,30,30,0.2,-50,40
119,35,5,3026,-60,0,60,60,1,20,20,0.166666667,-50,40
119,36,6,3043,50,100,50,50,1,-10,10,0.2,50,60
119,37,7,2921,-40,20,60,40,1,0,0,0.5,-50,60
119,38,8,3116,10,60,50,10,1,10,10,0,10,40
119,39,9,4279,40,80,40,40,1,-20,20,1,50,60
119,40,10,2819,0,80,80,0,1,20,20,,,60
119,41,11,2927,10,60,50,10,1,10,10,1,10,40
119,42,12,2905,20,80,60,20,1,20,20,0.5,10,40
119,43,13,3364,-60,20,80,60,1,20,20,0.166666667,-50,60
119,44,14,3074,-50,20,70,50,1,30,30,0,-50,40
119,45,15,2943,30,100,70,30,1,10,10,0.333333333,30,60
119,46,16,4083,-70,0,70,70,1,30,30,0.142857143,-70,40
119,47,17,3041,-20,60,80,20,1,20,20,0,-10,60
119,48,18,3179,-40,40,80,40,1,20,20,0.25,-50,60
119,49,19,3281,-20,40,60,20,1,20,20,0,-10,40
119,50,20,4807,-20,40,60,20,1,20,20,0,-10,40
119,51,21,2859,10,80,70,10,1,10,10,1,10,60
119,52,22,3103,-60,20,80,60,1,20,20,0.166666667,-50,60
119,53,23,3092,0,60,60,0,1,20,20,,,40
119,54,24,2958,-10,60,70,10,1,10,10,0,-10,60
119,55,25,2958,-60,0,60,60,1,20,20,0,-50,40
119,56,26,2844,30,100,70,30,1,10,10,0,30,60
119,57,27,2810,-40,20,60,40,1,20,20,0,-50,40
119,58,28,3105,20,80,60,20,1,20,20,,10,40
119,59,29,2960,-30,40,70,30,1,10,10,,-30,60
120,0,0,4107,-75,0,75,75,1,35,35,0.866666667,-70,40
120,1,1,3834,-35,40,75,35,1,15,15,0.714285714,-30,60
120,2,2,2877,30,40,10,30,1,-30,30,2,30,40
120,3,3,3417,-30,20,50,30,1,-10,10,0,-30,60
120,4,4,2985,10,80,70,10,1,30,30,-1,10,40
120,5,5,3028,-40,20,60,40,1,20,20,0.375,-50,40
120,6,6,2968,10,60,50,10,1,-10,10,-1,10,60
120,7,7,2947,40,80,40,40,1,-20,20,0.75,50,60
120,8,8,3921,15,60,45,15,1,5,5,2,10,40
120,9,9,3024,30,100,70,30,1,10,10,-0.666666667,30,60
120,10,10,3307,10,60,50,10,1,-10,10,-1,10,60
120,11,11,3669,-35,40,75,35,1,35,35,-0.142857143,-30,40
120,12,12,4087,0,80,80,0,1,40,40,,,40
120,13,13,3045,-20,20,40,20,1,-20,20,-2.5,-10,60
120,14,14,2981,-70,20,90,70,1,50,50,1,-70,40
120,15,15,2854,-10,80,90,10,1,30,30,0,-10,60
120,16,16,2843,40,60,20,40,1,-20,20,1.5,50,40
120,17,17,2933,10,100,90,10,1,30,30,-1.5,10,60
120,18,18,2912,-35,40,75,35,1,15,15,0.714285714,-30,60
120,19,19,2867,-80,0,80,80,1,40,40,0.5,-70,40
120,20,20,3074,20,60,40,20,1,0,0,-1,10,40
120,21,21,2840,10,60,50,10,1,-10,10,1,10,60
120,22,22,2893,40,100,60,40,1,0,0,0.25,50,60
120,23,23,2921,20,40,20,20,1,-20,20,1,10,40
120,24,24,3099,-30,40,70,30,1,10,10,0,-30,60
120,25,25,2833,-20,20,40,20,1,0,0,1,-10,40
120,26,26,2915,10,80,70,10,1,10,10,0.5,10,60
120,27,27,3063,60,80,20,60,1,-20,20,0.333333333,50,40
120,28,28,2942,-40,0,40,40,1,0,0,,-50,40
120,29,29,3241,-55,20,75,55,1,15,15,,-50,60
120,30,0,3192,25,50,25,25,0,-35,35,-0.2,30,60
120,31,1,4032,-5,20,25,5,0,-15,15,0,-10,40
120,32,2,3383,35,60,25,35,0,-15,15,0.714285714,30,40
120,33,3,3030,50,70,20,50,0,-40,40,1.2,50,60
120,34,4,3175,-40,40,80,40,0,20,20,1.5,-50,60
120,35,5,5637,-10,40,50,10,0,10,10,0,-10,40
120,36,6,4946,0,50,50,0,0,10,10,,,40
120,37,7,3565,60,80,20,60,0,-40,40,0.5,50,60
120,38,8,3130,-20,30,50,20,0,10,10,0,-10,40
120,39,9,3157,10,60,50,10,0,-10,10,0,10,60
120,40,10,4315,-30,20,50,30,0,10,10,0,-30,40
120,41,11,3870,20,70,50,20,0,-10,10,-1.5,10,60
120,42,12,3213,40,60,20,40,0,-40,40,1.25,50,60
120,43,13,3449,10,60,50,10,0,10,10,2,10,40
120,44,14,2911,-30,40,70,30,0,10,10,0,-30,60
120,45,15,3066,-40,30,70,40,0,30,30,-0.25,-50,40
120,46,16,2993,-20,50,70,20,0,10,10,1,-10,60
120,47,17,3027,-40,40,80,40,0,40,40,0.75,-50,40
120,48,18,4128,30,80,50,30,0,-10,10,0,30,60
120,49,19,3242,0,50,50,0,0,10,10,,,40
120,50,20,2829,10,60,50,10,0,-10,10,-1,10,60
120,51,21,3124,10,50,40,10,0,-20,20,1,10,60
120,52,22,3170,0,30,30,0,0,-10,10,,,40
120,53,23,3083,-30,20,50,30,0,10,10,0.666666667,-30,40
120,54,24,2924,20,70,50,20,0,-10,10,1,10,60
120,55,25,2967,20,50,30,20,0,-10,10,2,10,40
120,56,26,3001,-10,60,70,10,0,30,30,3,-10,40
120,57,27,2948,-30,40,70,30,0,10,10,0.666666667,-30,60
120,58,28,2874,30,80,50,30,0,-10,10,,30,60
120,59,29,2912,0,40,40,0,0,0,0,,,40
121,0,0,3926,25,80,55,25,0,-5,5,0.2,30,60
121,1,1,5140,-40,30,70,40,0,30,30,0.5,-50,40
121,2,2,3003,-10,40,50,10,0,10,10,0,-10,40
121,3,3,3255,-10,50,60,10,0,0,0,-1,-10,60
121,4,4,3149,-10,60,70,10,0,10,10,1,-10,60
121,5,5,3123,-30,20,50,30,0,10,10,0,-30,40
121,6,6,3256,0,50,50,0,0,10,10,,,40
121,7,7,3667,10,70,60,10,0,0,0,-2,10,60
121,8,8,3113,10,60,50,10,0,10,10,-0.9,10,40
121,9,9,3130,0,40,40,0,0,-20,20,,,60
121,10,10,4438,9,50,41,9,0,1,1,-0.111111111,10,40
121,11,11,3158,0,50,50,0,0,-10,10,,,60
121,12,12,3126,20,80,60,20,0,0,0,0.5,10,60
121,13,13,3224,20,60,40,20,0,0,0,0.5,10,40
121,14,14,2967,-30,40,70,30,0,10,10,0.333333333,-30,60
121,15,15,5989,-30,20,50,30,0,10,10,0,-30,40
121,16,16,3233,10,70,60,10,0,0,0,0,10,60
121,17,17,3212,-20,30,50,20,0,10,10,0.5,-10,40
121,18,18,3551,0,60,60,0,0,0,0,,,60
121,19,19,3236,0,40,40,0,0,0,0,,,40
121,20,20,3099,40,70,30,40,0,-30,30,0.75,50,60
121,21,21,3004,-20,40,60,20,0,0,0,0,-10,60
121,22,22,3371,-10,30,40,10,0,0,0,0,-10,40
121,23,23,4206,20,60,40,20,0,0,0,0.5,10,40
121,24,24,3305,20,80,60,20,0,0,0,0,10,60
121,25,25,2939,0,50,50,0,0,10,10,,,40
121,26,26,3416,-20,40,60,20,0,20,20,1,-10,40
121,27,27,3307,0,60,60,0,0,0,0,,,60
121,28,28,3598,-10,50,60,10,0,0,0,,-10,60
121,29,29,3013,-20,20,40,20,0,0,0,,-10,40
121,30,0,3764,-20,40,60,20,1,20,20,0,-10,40
121,31,1,3654,20,60,40,20,1,-20,20,0,10,60
121,32,2,3059,20,80,60,20,1,20,20,0,10,40
121,33,3,3276,-20,20,40,20,1,-20,20,0,-10,60
121,34,4,3193,0,60,60,0,1,20,20,,,40
121,35,5,4048,-30,20,50,30,1,10,10,0.666666667,-30,40
121,36,6,3956,60,100,40,60,1,-20,20,0.333333333,50,60
121,37,7,2952,20,80,60,20,1,0,0,0,10,60
121,38,8,3117,-30,0,30,30,1,-10,10,-0.333333333,-30,40
121,39,9,3605,-20,40,60,20,1,0,0,1,-10,60
121,40,10,4025,40,80,40,40,1,-20,20,0.5,50,60
121,41,11,2984,20,60,40,20,1,0,0,-0.5,10,40
121,42,12,3103,50,80,30,50,1,-10,10,0.4,50,40
121,43,13,3094,0,60,60,0,1,0,0,,,60
121,44,14,2903,-30,20,50,30,1,10,10,1,-30,40
121,45,15,3280,-40,20,60,40,1,0,0,0.75,-50,60
121,46,16,2806,-20,0,20,20,1,-20,20,0.5,-10,40
121,47,17,3340,10,40,30,10,1,-30,30,1,10,60
121,48,18,3223,60,100,40,60,1,-20,20,0,50,60
121,49,19,3413,30,40,10,30,1,-30,30,0.333333333,30,40
121,50,20,3242,40,60,20,40,1,-20,20,0,50,40
121,51,21,3205,-20,20,40,20,1,-20,20,-1,-10,60
121,52,22,2888,-20,40,60,20,1,0,0,1,-10,60
121,53,23,3679,0,20,20,0,1,-20,20,,,40
121,54,24,2994,40,80,40,40,1,-20,20,0,50,60
121,55,25,3073,-60,0,60,60,1,20,20,0.5,-50,40
121,56,26,3090,20,60,40,20,1,-20,20,0,10,60
121,57,27,3225,10,40,30,10,1,-10,10,-1,10,40
121,58,28,3172,60,80,20,60,1,-20,20,,50,40
121,59,29,3078,60,100,40,60,1,-20,20,,50,60
122,0,0,5014,20,80,60,20,0,0,0,0,10,60
122,1,1,4769,40,60,20,40,0,-20,20,0.5,50,40
122,2,2,4707,0,40,40,0,0,0,0,,,40
122,3,3,5295,0,60,60,0,0,0,0,,,60
122,4,4,5000,50,70,20,50,0,-40,40,0.6,50,60
122,5,5,4598,-10,30,40,10,0,0,0,1,-10,40
122,6,6,4821,-10,20,30,10,0,-10,10,-3,-10,40
122,7,7,5330,0,50,50,0,0,-10,10,,,60
122,8,8,5273,-10,50,60,10,0,20,20,2,-10,40
122,9,9,5297,-50,40,90,50,0,30,30,0.4,-50,60
122,10,10,5579,-10,30,40,10,0,0,0,1,-10,40
122,11,11,5442,-20,50,70,20,0,10,10,1,-10,60
122,12,12,5015,-10,40,50,10,0,-10,10,1,-10,60
122,13,13,4912,20,50,30,20,0,-10,10,1,10,40
122,14,14,4848,20,60,40,20,0,-20,20,1,10,60
122,15,15,5286,-30,20,50,30,0,10,10,0,-30,40
122,16,16,4988,20,80,60,20,0,0,0,0.5,10,60
122,17,17,5175,10,60,50,10,0,10,10,0,10,40
122,18,18,4969,0,70,70,0,0,10,10,,,60
122,19,19,5258,-10,40,50,10,0,10,10,3,-10,40
122,20,20,5318,-20,50,70,20,0,10,10,0,-10,60
122,21,21,5003,-30,40,70,30,0,10,10,0.333333333,-30,60
122,22,22,5305,40,60,20,40,0,-20,20,0.25,50,40
122,23,23,5105,10,40,30,10,0,-10,10,2,10,40
122,24,24,5166,10,70,60,10,0,0,0,1,10,60
122,25,25,5675,0,50,50,0,0,10,10,,,40
122,26,26,4877,-20,20,40,20,0,0,0,0,-10,40
122,27,27,4785,10,80,70,10,0,10,10,1,10,60
122,28,28,5243,-20,60,80,20,0,20,20,,-10,60
122,29,29,5053,-10,30,40,10,0,0,0,,-10,40
122,30,0,5144,-40,20,60,40,1,20,20,0.75,-50,40
122,31,1,5006,0,60,60,0,1,0,0,,,60
122,32,2,5096,-30,0,30,30,1,-10,10,0,-30,40
122,33,3,4742,-50,20,70,50,1,10,10,0.8,-50,60
122,34,4,4981,30,60,30,30,1,-10,10,1.333333333,30,40
122,35,5,4836,10,80,70,10,1,30,30,-3,10,40
122,36,6,4807,10,40,30,10,1,-30,30,1,10,60
122,37,7,4846,60,100,40,60,1,-20,20,0.666666667,50,60
122,38,8,4904,0,40,40,0,1,0,0,,,40
122,39,9,5320,0,80,80,0,1,20,20,,,60
122,40,10,5354,10,100,90,10,1,30,30,-7,10,60
122,41,11,5008,20,40,20,20,1,-20,20,0.5,10,40
122,42,12,4746,-30,0,30,30,1,-10,10,-0.666666667,-30,40
122,43,13,5035,20,40,20,20,1,-40,40,4,10,60
122,44,14,5191,-30,20,50,30,1,10,10,0.333333333,-30,40
122,45,15,5333,-80,20,100,80,1,40,40,0.5,-70,60
122,46,16,5017,40,80,40,40,1,0,0,-0.5,50,40
122,47,17,5376,0,60,60,0,1,0,0,,,60
122,48,18,4730,60,80,20,60,1,-40,40,1.166666667,50,60
122,49,19,4699,40,60,20,40,1,-20,20,0,50,40
122,50,20,5194,0,20,20,0,1,-20,20,,,40
122,51,21,4975,-50,40,90,50,1,30,30,0.4,-50,60
122,52,22,5236,30,100,70,30,1,10,10,0.666666667,30,60
122,53,23,4823,-70,0,70,70,1,30,30,0.571428571,-70,40
122,54,24,5121,-10,80,90,10,1,30,30,1,-10,60
122,55,25,4758,30,60,30,30,1,-10,10,0.333333333,30,40
122,56,26,4944,-60,20,80,60,1,20,20,0.5,-50,60
122,57,27,4768,40,80,40,40,1,0,0,0.75,50,40
122,58,28,5167,-30,40,70,30,1,30,30,,-30,40
122,59,29,5113,10,60,50,10,1,-10,10,,10,60
123,0,0,4603,-50,0,50,50,1,10,10,0.6,-50,40
123,1,1,4669,30,80,50,30,1,-10,10,-1,30,60
123,2,2,6119,60,80,20,60,1,-20,20,0.666666667,50,40
123,3,3,4610,80,100,20,80,1,-40,40,0.625,70,60
123,4,4,5187,-40,20,60,40,1,20,20,0.5,-50,40
123,5,5,4999,0,40,40,0,1,0,0,,,40
123,6,6,4699,-10,60,70,10,1,10,10,1,-10,60
123,7,7,7009,-40,20,60,40,1,0,0,0,-50,60
123,8,8,4394,20,60,40,20,1,0,0,1,10,40
123,9,9,4496,-20,40,60,20,1,0,0,0,-10,60
123,10,10,4341,-40,20,60,40,1,0,0,0,-50,60
123,11,11,4741,-60,0,60,60,1,20,20,0.166666667,-50,40
123,12,12,4190,-10,40,50,10,1,10,10,0,-10,40
123,13,13,4566,40,100,60,40,1,0,0,0.375,50,60
123,14,14,6422,-30,20,50,30,1,10,10,1.166666667,-30,40
123,15,15,4489,5,80,75,5,1,15,15,-1,10,60
123,16,16,5025,45,60,15,45,1,-25,25,0.555555556,50,40
123,17,17,4223,-10,60,70,10,1,10,10,2,-10,60
123,18,18,4644,-10,40,50,10,1,-10,10,-1,-10,60
123,19,19,4726,40,80,40,40,1,0,0,-0.5,50,40
123,20,20,4233,-20,0,20,20,1,-20,20,-1,-10,40
123,21,21,4750,-20,40,60,20,1,0,0,0,-10,60
123,22,22,4392,0,60,60,0,1,0,0,,,60
123,23,23,4773,-20,20,40,20,1,0,0,0.5,-10,40
123,24,24,6706,10,80,70,10,1,10,10,0,10,60
123,25,25,4179,30,60,30,30,1,-10,10,0.333333333,30,40
123,26,26,3491,30,100,70,30,1,10,10,0,30,60
123,27,27,4605,40,80,40,40,1,0,0,0,50,40
123,28,28,4380,0,40,40,0,1,0,0,,,40
123,29,29,3455,-50,20,70,50,1,10,10,,-50,60
123,30,0,4617,30,80,50,30,0,-10,10,0.666666667,30,60
123,31,1,4306,-30,20,50,30,0,10,10,-0.666666667,-30,40
123,32,2,3578,-40,30,70,40,0,30,30,1,-50,40
123,33,3,3814,-10,60,70,10,0,10,10,-1,-10,60
123,34,4,5413,-30,50,80,30,0,20,20,0.333333333,-30,60
123,35,5,4696,10,40,30,10,0,-10,10,1,10,40
123,36,6,4215,20,60,40,20,0,0,0,0.5,10,40
123,37,7,3986,0,70,70,0,0,10,10,,,60
123,38,8,4847,0,50,50,0,0,10,10,,,40
123,39,9,3449,-30,40,70,30,0,10,10,0,-30,60
123,40,10,4292,10,50,40,10,0,0,0,0,10,40
123,41,11,3441,-10,60,70,10,0,10,10,2.5,-10,60
123,42,12,4773,35,80,45,35,0,-15,15,0.714285714,30,60
123,43,13,4219,-20,20,40,20,0,0,0,-1.5,-10,40
123,44,14,3818,-20,50,70,20,0,10,10,0,-10,60
123,45,15,4072,-30,40,70,30,0,30,30,1,-30,40
123,46,16,3246,-30,40,70,30,0,10,10,0,-30,60
123,47,17,4233,-10,30,40,10,0,0,0,0,-10,40
123,48,18,3297,0,70,70,0,0,10,10,,,60
123,49,19,4215,20,60,40,20,0,0,0,1.5,10,40
123,50,20,3163,-20,50,70,20,0,10,10,0,-10,60
123,51,21,7006,0,70,70,0,0,10,10,,,60
123,52,22,3302,-30,40,70,30,0,30,30,1,-30,40
123,53,23,4452,20,60,40,20,0,0,0,0.5,10,40
123,54,24,3353,10,80,70,10,0,10,10,2,10,60
123,55,25,4303,-30,20,50,30,0,10,10,0.333333333,-30,40
123,56,26,4854,-10,30,40,10,0,0,0,-0.5,-10,40
123,57,27,4141,-50,40,90,50,0,30,30,0.4,-50,60
123,58,28,3463,-10,60,70,10,0,10,10,,-10,60
123,59,29,4539,5,50,45,5,0,5,5,,10,40
124,0,0,4372,-10,60,70,10,0,10,10,1,-10,60
124,1,1,4956,-20,30,50,20,0,10,10,1.5,-10,40
124,2,2,4375,30,50,20,30,0,-20,20,0.666666667,30,40
124,3,3,4548,20,80,60,20,0,0,0,1.5,10,60
124,4,4,4133,-40,50,90,40,0,30,30,0.75,-50,60
124,5,5,4488,-20,20,40,20,0,0,0,1,-10,40
124,6,6,4190,40,60,20,40,0,-20,20,0.5,50,40
124,7,7,4523,10,70,60,10,0,0,0,-1,10,60
124,8,8,4835,0,40,40,0,0,0,0,,,40
124,9,9,4889,-10,40,50,10,0,-10,10,0,-10,60
124,10,10,5354,-20,40,60,20,0,20,20,1,-10,40
124,11,11,4401,10,60,50,10,0,-10,10,1,10,60
124,12,12,4459,-20,40,60,20,0,0,0,0,-10,60
124,13,13,4674,-10,30,40,10,0,0,0,0,-10,40
124,14,14,4349,-10,50,60,10,0,0,0,1,-10,60
124,15,15,4609,10,50,40,10,0,0,0,0,10,40
124,16,16,4961,20,70,50,20,0,-10,10,0.5,10,60
124,17,17,5071,-20,20,40,20,0,0,0,1,-10,40
124,18,18,4535,20,80,60,20,0,0,0,0,10,60
124,19,19,4947,40,60,20,40,0,-20,20,0.5,50,40
124,20,20,4338,0,60,60,0,0,0,0,,,60
124,21,21,4334,10,80,70,10,0,10,10,0,10,60
124,22,22,4887,0,40,40,0,0,0,0,,,40
124,23,23,5376,20,60,40,20,0,0,0,0,10,40
124,24,24,4592,-20,50,70,20,0,10,10,0,-10,60
124,25,25,4470,-10,30,40,10,0,0,0,1,-10,40
124,26,26,4595,20,50,30,20,0,-10,10,0.5,10,40
124,27,27,5911,-30,40,70,30,0,10,10,-0.333333333,-30,60
124,28,28,5012,-10,70,80,10,0,20,20,,-10,60
124,29,29,4673,-20,20,40,20,0,0,0,,-10,40
124,30,0,4728,10,80,70,10,1,30,30,0,10,40
124,31,1,4477,20,60,40,20,1,-20,20,0.5,10,60
124,32,2,4787,-50,20,70,50,1,30,30,0.2,-50,40
124,33,3,5685,-10,40,50,10,1,-10,10,-1,-10,60
124,34,4,4828,0,60,60,0,1,20,20,,,40
124,35,5,5234,-30,40,70,30,1,30,30,1,-30,40
124,36,6,4980,20,80,60,20,1,0,0,-1,10,60
124,37,7,4846,-20,20,40,20,1,-20,20,0.5,-10,60
124,38,8,4371,-40,0,40,40,1,0,0,-0.5,-50,40
124,39,9,4491,70,100,30,70,1,-30,30,0.857142857,70,60
124,40,10,5213,-70,20,90,70,1,30,30,0.428571429,-70,60
124,41,11,4896,0,60,60,0,1,20,20,,,40
124,42,12,5411,0,40,40,0,1,0,0,,,40
124,43,13,4586,40,100,60,40,1,0,0,0,50,60
124,44,14,4440,-70,0,70,70,1,30,30,1,-70,40
124,45,15,4334,20,80,60,20,1,0,0,-2.7,10,60
124,46,16,4328,20,20,0,20,1,-40,40,2,10,40
124,47,17,7044,34,40,6,34,1,-54,54,1.588235294,30,60
124,48,18,5184,0,60,60,0,1,0,0,,,60
124,49,19,5247,40,80,40,40,1,0,0,0,50,40
124,50,20,4848,0,40,40,0,1,0,0,,,40
124,51,21,4743,-40,40,80,40,1,20,20,0.25,-50,60
124,52,22,4786,10,80,70,10,1,10,10,-1,10,60
124,53,23,7041,,0,,,1,,,,,40
124,54,24,4727,-40,20,60,40,1,0,0,-0.25,-50,60
124,55,25,5383,-20,20,40,20,1,0,0,1,-10,40
124,56,26,5625,30,100,70,30,1,10,10,0,30,60
124,57,27,5112,60,80,20,60,1,-20,20,0.333333333,50,40
124,58,28,4623,20,60,40,20,1,0,0,,10,40
124,59,29,4784,-10,60,70,10,1,10,10,,-10,60
125,0,0,4981,-30,0,30,30,1,-10,10,-1.333333333,-30,40
125,1,1,3220,-20,40,60,20,1,0,0,0.5,-10,60
125,2,2,3079,-50,20,70,50,1,30,30,-0.2,-50,40
125,3,3,3321,10,60,50,10,1,-10,10,2,10,60
125,4,4,5334,-40,40,80,40,1,40,40,1,-50,40
125,5,5,3266,40,80,40,40,1,0,0,-0.25,50,40
125,6,6,2908,10,80,70,10,1,10,10,-3,10,60
125,7,7,3043,60,100,40,60,1,-20,20,-0.333333333,50,60
125,8,8,3061,30,60,30,30,1,-10,10,-1,30,40
125,9,9,2928,0,20,20,0,1,-40,40,,,60
125,10,10,2870,-10,40,50,10,1,-10,10,2,-10,60
125,11,11,2956,80,80,0,80,1,-40,40,1.125,70,40
125,12,12,3621,-90,0,90,90,1,50,50,0.222222222,-70,40
125,13,13,2819,-10,20,30,10,1,-30,30,-1,-10,60
125,14,14,3062,-30,40,70,30,1,30,30,-0.333333333,-30,40
125,15,15,3278,40,80,40,40,1,-20,20,-0.75,50,60
125,16,16,4055,-20,60,80,20,1,40,40,-1,-10,40
125,17,17,4002,90,100,10,90,1,-50,50,0.777777778,70,60
125,18,18,4127,-20,60,80,20,1,20,20,0,-10,60
125,19,19,3804,-80,20,100,80,1,60,60,0.5,-70,40
125,20,20,3323,-60,0,60,60,1,20,20,0.666666667,-50,40
125,21,21,3177,20,100,80,20,1,20,20,-0.5,10,60
125,22,22,3228,-30,40,70,30,1,10,10,0.333333333,-30,60
125,23,23,3475,40,60,20,40,1,-20,20,1,50,40
125,24,24,4402,20,80,60,20,1,0,0,0.5,10,60
125,25,25,3764,-40,20,60,40,1,20,20,-0.5,-50,40
125,26,26,3454,-50,20,70,50,1,10,10,0.6,-50,60
125,27,27,3185,-40,40,80,40,1,40,40,0.75,-50,40
125,28,28,3088,30,80,50,30,1,10,10,,30,40
125,29,29,4234,20,60,40,20,1,-20,20,,10,60
125,30,0,4173,20,40,20,20,0,-40,40,2,10,60
125,31,1,3137,-20,60,80,20,0,40,40,1.5,-10,40
125,32,2,3152,-30,20,50,30,0,10,10,-1,-30,40
125,33,3,2978,-10,50,60,10,0,0,0,2,-10,60
125,34,4,3351,20,60,40,20,0,-20,20,-2,10,60
125,35,5,4511,-50,30,80,50,0,40,40,0.2,-50,40
125,36,6,3009,-30,40,70,30,0,30,30,0,-30,40
125,37,7,2929,70,70,0,70,0,-60,60,1.428571429,70,60
125,38,8,4452,-20,50,70,20,0,30,30,2,-10,40
125,39,9,3984,-20,80,100,20,0,40,40,2.5,-10,60
125,40,10,4651,20,50,30,20,0,-10,10,2.5,10,40
125,41,11,5428,10,60,50,10,0,-10,10,2,10,60
125,42,12,3081,-20,50,70,20,0,10,10,0.5,-10,60
125,43,13,3616,-60,20,80,60,0,40,40,1,-50,40
125,44,14,4070,20,80,60,20,0,0,0,0.5,10,60
125,45,15,4090,10,30,20,10,0,-20,20,6,10,40
125,46,16,4033,-30,40,70,30,0,10,10,0.333333333,-30,60
125,47,17,4323,-20,60,80,20,0,40,40,1,-10,40
125,48,18,3832,10,70,60,10,0,0,0,-2,10,60
125,49,19,4140,-20,40,60,20,0,20,20,-1,-10,40
125,50,20,3453,0,40,40,0,0,-20,20,,,60
125,51,21,3410,20,70,50,20,0,-10,10,1,10,60
125,52,22,4438,-50,30,80,50,0,40,40,1,-50,40
125,53,23,4072,10,40,30,10,0,-10,10,4,10,40
125,54,24,3125,-10,60,70,10,0,10,10,2,-10,60
125,55,25,3261,-10,60,70,10,0,30,30,4,-10,40
125,56,26,2951,-10,20,30,10,0,-10,10,1,-10,40
125,57,27,3902,30,80,50,30,0,-10,10,-1.433333333,30,60
125,58,28,2954,43,50,7,43,0,-53,53,,50,60
125,59,29,4485,30,50,20,30,0,-20,20,,30,40
126,0,0,3552,-20,50,70,20,0,10,10,-1,-10,60
126,1,1,3447,0,30,30,0,0,-10,10,,,40
126,2,2,2914,30,50,20,30,0,-20,20,0.333333333,30,40
126,3,3,3224,-20,70,90,20,0,30,30,1,-10,60
126,4,4,3142,-30,40,70,30,0,10,10,0,-30,60
126,5,5,3591,30,60,30,30,0,-10,10,0.333333333,30,40
126,6,6,5287,0,40,40,0,0,0,0,,,40
126,7,7,2923,10,80,70,10,0,10,10,-1,10,60
126,8,8,3514,-10,20,30,10,0,-10,10,0,-10,40
126,9,9,3792,0,60,60,0,0,0,0,,,60
126,10,10,3182,0,30,30,0,0,-10,10,,,40
126,11,11,3068,-20,50,70,20,0,10,10,0,-10,60
126,12,12,2855,0,70,70,0,0,10,10,,,60
126,13,13,2981,-20,20,40,20,0,0,0,0,-10,40
126,14,14,3408,-10,40,50,10,0,-10,10,-1,-10,60
126,15,15,2888,20,60,40,20,0,0,0,-0.5,10,40
126,16,16,3705,0,60,60,0,0,0,0,,,60
126,17,17,3872,20,50,30,20,0,-10,10,0.5,10,40
126,18,18,3755,10,80,70,10,0,10,10,-1,10,60
126,19,19,5056,0,40,40,0,0,0,0,,,40
126,20,20,3156,-20,40,60,20,0,0,0,0,-10,60
126,21,21,5280,-10,50,60,10,0,0,0,0,-10,60
126,22,22,4051,-20,20,40,20,0,0,0,1,-10,40
126,23,23,3053,10,30,20,10,0,-20,20,3,10,40
126,24,24,3789,0,60,60,0,0,0,0,,,60
126,25,25,3507,0,50,50,0,0,10,10,,,40
126,26,26,2811,20,60,40,20,0,0,0,0.5,10,40
126,27,27,2826,10,80,70,10,0,10,10,-1,10,60
126,28,28,5111,10,70,60,10,0,0,0,,10,60
126,29,29,4086,-10,40,50,10,0,10,10,,-10,40
126,30,0,3151,30,80,50,30,1,10,10,0.666666667,30,40
126,31,1,2810,10,60,50,10,1,-10,10,1,10,60
126,32,2,2822,-30,40,70,30,1,30,30,1,-30,40
126,33,3,2987,20,80,60,20,1,0,0,0,10,60
126,34,4,3892,20,60,40,20,1,0,0,2.5,10,40
126,35,5,2890,-90,0,90,90,1,50,50,0.666666667,-70,40
126,36,6,2871,40,100,60,40,1,0,0,0.25,50,60
126,37,7,2761,-30,40,70,30,1,10,10,0.333333333,-30,60
126,38,8,3997,-10,20,30,10,1,-10,10,-1,-10,40
126,39,9,3268,-40,20,60,40,1,0,0,0.5,-50,60
126,40,10,3632,60,100,40,60,1,-20,20,0.666666667,50,60
126,41,11,5165,20,60,40,20,1,0,0,-2,10,40
126,42,12,2944,0,0,0,0,1,-40,40,,,40
126,43,13,2978,-40,40,80,40,1,20,20,0,-50,60
126,44,14,2772,40,40,0,40,1,-40,40,0.5,50,40
126,45,15,4251,0,80,80,0,1,20,20,,,60
126,46,16,3344,0,20,20,0,1,-20,20,,,40
126,47,17,4156,-50,20,70,50,1,10,10,0.4,-50,60
126,48,18,4289,10,60,50,10,1,-10,10,3,10,60
126,49,19,5042,70,80,10,70,1,-30,30,0.142857143,70,40
126,50,20,5577,40,60,20,40,1,-20,20,0.25,50,40
126,51,21,5322,-40,40,80,40,1,20,20,0.5,-50,60
126,52,22,4137,-40,20,60,40,1,0,0,0,-50,60
126,53,23,5627,-10,20,30,10,1,-10,10,3,-10,40
126,54,24,5087,0,60,60,0,1,0,0,,,60
126,55,25,3169,40,40,0,40,1,-40,40,1,50,40
126,56,26,4111,0,80,80,0,1,20,20,,,60
126,57,27,4845,-40,0,40,40,1,0,0,0.5,-50,40
126,58,28,4339,60,80,20,60,1,-20,20,,50,40
126,59,29,3809,60,100,40,60,1,-20,20,,50,60
127,0,0,5677,10,70,60,10,0,0,0,0,10,60
127,1,1,4225,-30,20,50,30,0,10,10,-0.333333333,-30,40
127,2,2,6841,0,60,60,0,0,20,20,,,40
127,3,3,4799,0,60,60,0,0,0,0,,,60
127,4,4,5390,0,40,40,0,0,-20,20,,,60
127,5,5,4390,0,50,50,0,0,10,10,,,40
127,6,6,5498,-10,30,40,10,0,0,0,-1,-10,40
127,7,7,4667,-20,50,70,20,0,10,10,0.5,-10,60
127,8,8,4676,-10,40,50,10,0,10,10,1,-10,40
127,9,9,4841,20,80,60,20,0,0,0,0,10,60
127,10,10,4584,-20,20,40,20,0,0,0,0.5,-10,40
127,11,11,4709,-10,50,60,10,0,0,0,3,-10,60
127,12,12,4990,50,80,30,50,0,-30,30,0.2,50,60
127,13,13,4709,10,40,30,10,0,-10,10,-1,10,40
127,14,14,4514,30,70,40,30,0,-20,20,0.666666667,30,60
127,15,15,4484,30,50,20,30,0,-20,20,0.666666667,30,40
127,16,16,4559,0,60,60,0,0,0,0,,,60
127,17,17,5646,-10,30,40,10,0,0,0,0,-10,40
127,18,18,4671,10,40,30,10,0,-30,30,3,10,60
127,19,19,4358,20,60,40,20,0,0,0,0,10,40
127,20,20,4539,20,80,60,20,0,0,0,0,10,60
127,21,21,3544,0,60,60,0,0,0,0,,,60
127,22,22,3752,10,50,40,10,0,0,0,0,10,40
127,23,23,5143,-10,30,40,10,0,0,0,1,-10,40
127,24,24,4132,0,70,70,0,0,10,10,,,60
127,25,25,3729,30,60,30,30,0,-10,10,0,30,40
127,26,26,4935,10,40,30,10,0,-10,10,1,10,40
127,27,27,4329,-30,40,70,30,0,10,10,0,-30,60
127,28,28,3871,-20,50,70,20,0,10,10,,-10,60
127,29,29,3361,-20,20,40,20,0,0,0,,-10,40
127,30,0,4233,-50,0,50,50,1,10,10,0.8,-50,40
127,31,1,4741,30,80,50,30,1,-10,10,0.333333333,30,60
127,32,2,4284,70,80,10,70,1,-30,30,0.285714286,70,40
127,33,3,4797,-20,40,60,20,1,0,0,0.5,-10,60
127,34,4,3886,30,60,30,30,1,-10,10,0.666666667,30,40
127,35,5,3241,-30,20,50,30,1,10,10,0.333333333,-30,40
127,36,6,3431,-30,20,50,30,1,-10,10,0.333333333,-30,60
127,37,7,3157,60,100,40,60,1,-20,20,0.333333333,50,60
127,38,8,3208,0,40,40,0,1,0,0,,,40
127,39,9,3580,0,60,60,0,1,0,0,,,60
127,40,10,3332,-30,20,50,30,1,-10,10,0,-30,60
127,41,11,3166,-30,0,30,30,1,-10,10,-0.333333333,-30,40
127,42,12,4331,0,40,40,0,1,0,0,,,40
127,43,13,4346,-10,40,50,10,1,-10,10,0,-10,60
127,44,14,3487,60,80,20,60,1,-20,20,1,50,40
127,45,15,3686,10,60,50,10,1,-10,10,0,10,60
127,46,16,6283,-20,60,80,20,1,40,40,2,-10,40
127,47,17,4463,30,80,50,30,1,-10,10,0,30,60
127,48,18,4696,50,100,50,50,1,-10,10,0.2,50,60
127,49,19,4357,-20,20,40,20,1,0,0,0,-10,40
127,50,20,4963,20,60,40,20,1,0,0,-2,10,40
127,51,21,4808,40,100,60,40,1,0,0,-0.5,50,60
127,52,22,3836,0,40,40,0,1,-20,20,,,60
127,53,23,3093,40,40,0,40,1,-40,40,1.25,50,40
127,54,24,5678,-20,80,100,20,1,40,40,1.5,-10,60
127,55,25,5209,-30,20,50,30,1,10,10,0.333333333,-30,40
127,56,26,4866,-50,20,70,50,1,10,10,0.4,-50,60
127,57,27,5755,40,80,40,40,1,0,0,0.25,50,40
127,58,28,4244,-50,0,50,50,1,10,10,,-50,40
127,59,29,4348,10,60,50,10,1,-10,10,,10,60
128,0,0,4696,-50,0,50,50,1,10,10,0,-50,40
128,1,1,4193,-60,20,80,60,1,20,20,0.666666667,-50,60
128,2,2,5721,10,60,50,10,1,10,10,-2,10,40
128,3,3,4154,20,60,40,20,1,-20,20,-0.5,10,60
128,4,4,4603,50,80,30,50,1,-10,10,0.6,50,40
128,5,5,5787,-40,20,60,40,1,20,20,0.5,-50,40
128,6,6,4938,10,40,30,10,1,-30,30,1,10,60
128,7,7,4795,60,100,40,60,1,-20,20,0.5,50,60
128,8,8,4140,0,40,40,0,1,0,0,,,40
128,9,9,4162,10,80,70,10,1,10,10,1,10,60
128,10,10,4530,-60,20,80,60,1,20,20,0.166666667,-50,60
128,11,11,5706,-20,0,20,20,1,-20,20,-1,-10,40
128,12,12,4833,-20,20,40,20,1,0,0,0.5,-10,40
128,13,13,6260,30,100,70,30,1,10,10,0.333333333,30,60
128,14,14,5610,50,80,30,50,1,-10,10,1,50,40
128,15,15,4715,-40,40,80,40,1,20,20,0.25,-50,60
128,16,16,4530,-40,40,80,40,1,40,40,1.5,-50,40
128,17,17,5267,-10,60,70,10,1,10,10,-1,-10,60
128,18,18,5035,0,80,80,0,1,20,20,,,60
128,19,19,4850,40,60,20,40,1,-20,20,0.25,50,40
128,20,20,5738,30,60,30,30,1,-10,10,-0.333333333,30,40
128,21,21,6851,-20,20,40,20,1,-20,20,-2,-10,60
128,22,22,4148,20,100,80,20,1,20,20,0,10,60
128,23,23,5241,20,40,20,20,1,-20,20,0,10,40
128,24,24,4789,-40,40,80,40,1,20,20,-0.25,-50,60
128,25,25,3610,-20,0,20,20,1,-20,20,-0.5,-10,40
128,26,26,3898,-30,60,90,30,1,30,30,0.666666667,-30,60
128,27,27,5178,50,80,30,50,1,-10,10,0.4,50,40
128,28,28,3792,-30,20,50,30,1,10,10,,-30,40
128,29,29,3844,10,80,70,10,1,10,10,,10,60
128,30,0,3508,0,80,80,0,0,20,20,,,60
128,31,1,2770,-10,40,50,10,0,10,10,3,-10,40
128,32,2,3666,40,60,20,40,0,-20,20,0.5,50,40
128,33,3,3226,0,70,70,0,0,10,10,,,60
128,34,4,2893,0,60,60,0,0,0,0,,,60
128,35,5,4467,10,50,40,10,0,0,0,-1,10,40
128,36,6,2842,-10,20,30,10,0,-10,10,0,-10,40
128,37,7,4274,0,50,50,0,0,-10,10,,,60
128,38,8,3801,0,30,30,0,0,-10,10,,,40
128,39,9,3274,-30,40,70,30,0,10,10,-0.333333333,-30,60
128,40,10,3138,-20,30,50,20,0,10,10,1.5,-10,40
128,41,11,2737,-40,40,80,40,0,20,20,0.25,-50,60
128,42,12,2938,0,70,70,0,0,10,10,,,60
128,43,13,4108,20,40,20,20,0,-20,20,0,10,40
128,44,14,3849,-30,50,80,30,0,20,20,0,-30,60
128,45,15,3394,40,60,20,40,0,-20,20,0,50,40
128,46,16,3699,0,80,80,0,0,20,20,,,60
128,47,17,2794,0,20,20,0,0,-20,20,,,40
128,48,18,2826,0,60,60,0,0,0,0,,,60
128,49,19,2652,0,50,50,0,0,10,10,,,40
128,50,20,3025,-40,40,80,40,0,20,20,0.75,-50,60
128,51,21,4041,20,70,50,20,0,-10,10,1,10,60
128,52,22,2866,30,60,30,30,0,-10,10,0,30,40
128,53,23,3530,-10,20,30,10,0,-10,10,-1,-10,40
128,54,24,2842,-10,60,70,10,0,10,10,1,-10,60
128,55,25,4195,0,40,40,0,0,0,0,,,40
128,56,26,4538,0,30,30,0,0,-10,10,,,40
128,57,27,3266,20,80,60,20,0,0,0,1,10,60
128,58,28,2889,-30,50,80,30,0,20,20,,-30,60
128,59,29,2715,30,50,20,30,0,-20,20,,30,40
129,0,0,3793,40,70,30,40,0,-30,30,1,50,60
129,1,1,2953,-10,40,50,10,0,10,10,0,-10,40
129,2,2,3862,10,60,50,10,0,10,10,-1,10,40
129,3,3,3239,-10,60,70,10,0,10,10,-1,-10,60
129,4,4,3772,-30,50,80,30,0,20,20,0,-30,60
129,5,5,3625,-10,30,40,10,0,0,0,0,-10,40
129,6,6,3003,10,50,40,10,0,0,0,1,10,40
129,7,7,3995,-40,40,80,40,0,20,20,0.5,-50,60
129,8,8,2650,-30,20,50,30,0,10,10,0.333333333,-30,40
129,9,9,3030,20,80,60,20,0,0,0,-0.5,10,60
129,10,10,2855,0,40,40,0,0,0,0,,,40
129,11,11,2906,0,50,50,0,0,-10,10,,,60
129,12,12,3049,-20,40,60,20,0,0,0,-0.5,-10,60
129,13,13,2919,0,50,50,0,0,10,10,,,40
129,14,14,3129,10,80,70,10,0,10,10,1,10,60
129,15,15,2996,-20,30,50,20,0,10,10,0.5,-10,40
129,16,16,2791,-20,60,80,20,0,20,20,0.5,-10,60
129,17,17,3066,20,60,40,20,0,0,0,0.5,10,40
129,18,18,3131,0,70,70,0,0,10,10,,,60
129,19,19,2760,-30,20,50,30,0,10,10,-0.666666667,-30,40
129,20,20,2823,-10,50,60,10,0,0,0,0,-10,60
129,21,21,3418,20,80,60,20,0,0,0,0,10,60
129,22,22,3001,-20,50,70,20,0,30,30,1,-10,40
129,23,23,6426,-20,30,50,20,0,10,10,0.5,-10,40
129,24,24,3126,0,60,60,0,0,0,0,,,60
129,25,25,2716,-20,20,40,20,0,0,0,-0.5,-10,40
129,26,26,2859,-10,40,50,10,0,10,10,2,-10,40
129,27,27,2776,-20,40,60,20,0,0,0,0.5,-10,60
129,28,28,2816,20,70,50,20,0,-10,10,,10,60
129,29,29,2759,30,60,30,30,0,-10,10,,30,40
129,30,0,5938,20,80,60,20,1,20,20,0.5,10,40
129,31,1,2888,-30,20,50,30,1,-10,10,-0.333333333,-30,60
129,32,2,3162,-50,20,70,50,1,30,30,0.8,-50,40
129,33,3,2920,0,60,60,0,1,0,0,,,60
129,34,4,3239,10,40,30,10,1,-10,10,2,10,40
129,35,5,3992,-50,0,50,50,1,10,10,-0.2,-50,40
129,36,6,3911,40,80,40,40,1,-20,20,0.75,50,60
129,37,7,3223,-30,40,70,30,1,10,10,1.666666667,-30,60
129,38,8,4298,0,60,60,0,1,20,20,,,40
129,39,9,2744,80,100,20,80,1,-40,40,0.5,70,60
129,40,10,3186,20,80,60,20,1,0,0,1,10,60
129,41,11,3385,30,60,30,30,1,-10,10,1,30,40
129,42,12,2913,-40,20,60,40,1,20,20,0.25,-50,40
129,43,13,3065,-20,60,80,20,1,20,20,0.5,-10,60
129,44,14,2696,-10,40,50,10,1,10,10,1,-10,40
129,45,15,3112,-50,20,70,50,1,10,10,0.2,-50,60
129,46,16,3685,40,80,40,40,1,0,0,0.75,50,40
129,47,17,4504,-20,40,60,20,1,0,0,0.5,-10,60
129,48,18,3594,50,100,50,50,1,-10,10,0.2,50,60
129,49,19,5129,-70,0,70,70,1,30,30,0.142857143,-70,40
129,50,20,2859,20,80,60,20,1,20,20,-0.5,10,40
129,51,21,3016,40,100,60,40,1,0,0,0.25,50,60
129,52,22,2762,-10,60,70,10,1,10,10,4,-10,60
129,53,23,2762,-30,20,50,30,1,10,10,1,-30,40
129,54,24,4279,-10,20,30,10,1,-30,30,-2,-10,60
129,55,25,3226,-20,0,20,20,1,-20,20,-1,-10,40
129,56,26,2904,30,80,50,30,1,-10,10,1.333333333,30,60
129,57,27,3142,20,60,40,20,1,0,0,-1,10,40
129,58,28,3805,20,40,20,20,1,-20,20,,10,40
129,59,29,3171,-50,40,90,50,1,30,30,,-50,60
130,0,0,4883,10,80,70,10,0,10,10,-1,10,60
130,1,1,4558,0,40,40,0,0,0,0,,,40
130,2,2,4275,-20,20,40,20,0,0,0,-1.5,-10,40
130,3,3,4327,0,60,60,0,0,0,0,,,60
130,4,4,4474,-10,70,80,10,0,20,20,0,-10,60
130,5,5,5415,-40,30,70,40,0,30,30,0.75,-50,40
130,6,6,4261,10,50,40,10,0,0,0,1,10,40
130,7,7,3465,-40,40,80,40,0,20,20,0.25,-50,60
130,8,8,4279,10,60,50,10,0,10,10,-1,10,40
130,9,9,3573,-20,50,70,20,0,10,10,0.5,-10,60
130,10,10,3495,10,50,40,10,0,0,0,2,10,40
130,11,11,4001,0,60,60,0,0,0,0,,,60
130,12,12,3436,0,70,70,0,0,10,10,,,60
130,13,13,3619,-30,30,60,30,0,20,20,0,-30,40
130,14,14,4567,10,80,70,10,0,10,10,1,10,60
130,15,15,3462,0,60,60,0,0,20,20,,,40
130,16,16,3347,-30,50,80,30,0,20,20,0.333333333,-30,60
130,17,17,3654,-40,20,60,40,0,20,20,0.25,-50,40
130,18,18,3306,-30,40,70,30,0,10,10,0.333333333,-30,60
130,19,19,3298,-10,40,50,10,0,10,10,1,-10,40
130,20,20,3441,-20,40,60,20,0,0,0,-0.5,-10,60
130,21,21,3615,10,80,70,10,0,10,10,-2,10,60
130,22,22,4893,10,50,40,10,0,0,0,-1,10,40
130,23,23,3235,30,60,30,30,0,-10,10,0,30,40
130,24,24,4439,10,60,50,10,0,-10,10,3,10,60
130,25,25,4168,10,40,30,10,0,-10,10,-1,10,40
130,26,26,4063,10,30,20,10,0,-20,20,1,10,40
130,27,27,3341,-30,50,80,30,0,20,20,1.333333333,-30,60
130,28,28,3424,30,70,40,30,0,-20,20,,30,60
130,29,29,3437,-10,20,30,10,0,-10,10,,-10,40
130,30,0,4388,-60,0,60,60,1,20,20,0.666666667,-50,40
130,31,1,3317,30,100,70,30,1,10,10,0,30,60
130,32,2,3266,60,80,20,60,1,-20,20,0.166666667,50,40
130,33,3,4419,10,80,70,10,1,10,10,2,10,60
130,34,4,3367,-10,20,30,10,1,-10,10,1,-10,40
130,35,5,3764,20,40,20,20,1,-20,20,0.5,10,40
130,36,6,3378,-30,60,90,30,1,30,30,0.666666667,-30,60
130,37,7,3279,-50,20,70,50,1,10,10,0.6,-50,60
130,38,8,3260,30,60,30,30,1,-10,10,-0.333333333,30,40
130,39,9,3218,0,40,40,0,1,-20,20,,,60
130,40,10,4088,-10,20,30,10,1,-30,30,1,-10,60
130,41,11,3965,-20,0,20,20,1,-20,20,-2,-10,40
130,42,12,3497,-40,20,60,40,1,20,20,0.75,-50,40
130,43,13,3743,80,100,20,80,1,-40,40,0.25,70,60
130,44,14,3601,30,60,30,30,1,-10,10,0.666666667,30,40
130,45,15,3313,20,60,40,20,1,-20,20,1,10,60
130,46,16,5127,-10,40,50,10,1,10,10,3,-10,40
130,47,17,4424,-20,40,60,20,1,0,0,1.5,-10,60
130,48,18,3323,50,80,30,50,1,-30,30,0.4,50,60
130,49,19,3219,60,80,20,60,1,-20,20,0.333333333,50,40
130,50,20,5096,-20,20,40,20,1,0,0,1,-10,40
130,51,21,3486,-10,40,50,10,1,-10,10,-1,-10,60
130,52,22,3429,40,100,60,40,1,0,0,0.75,50,60
130,53,23,3208,20,40,20,20,1,-20,20,0.5,10,40
130,54,24,3502,-30,60,90,30,1,30,30,0,-30,60
130,55,25,3610,50,80,30,50,1,-10,10,0.2,50,40
130,56,26,3247,-70,20,90,70,1,30,30,0,-70,60
130,57,27,4487,-40,0,40,40,1,0,0,0.25,-50,40
130,58,28,4185,30,60,30,30,1,-10,10,,30,40
130,59,29,3318,-10,80,90,10,1,30,30,,-10,60
131,0,0,3985,20,80,60,20,1,20,20,1.5,10,40
131,1,1,3370,-20,40,60,20,1,0,0,1,-10,60
131,2,2,3703,-50,40,90,50,1,50,50,1,-50,40
131,3,3,4519,60,100,40,60,1,-20,20,1,50,60
131,4,4,4450,-20,20,40,20,1,0,0,1,-10,40
131,5,5,4746,40,60,20,40,1,-20,20,1,50,40
131,6,6,3890,-20,80,100,20,1,40,40,1.5,-10,60
131,7,7,4776,-50,20,70,50,1,10,10,0.4,-50,60
131,8,8,4400,-60,0,60,60,1,20,20,0.666666667,-50,40
131,9,9,3647,10,60,50,10,1,-10,10,0,10,60
131,10,10,4159,-30,20,50,30,1,-10,10,0.333333333,-30,60
131,11,11,3392,0,20,20,0,1,-20,20,,,40
131,12,12,3402,30,60,30,30,1,-10,10,-0.333333333,30,40
131,13,13,3547,60,100,40,60,1,-20,20,-0.166666667,50,60
131,14,14,4527,20,40,20,20,1,-20,20,1.5,10,40
131,15,15,4389,50,80,30,50,1,-30,30,0.8,50,60
131,16,16,3973,-50,0,50,50,1,10,10,0.6,-50,40
131,17,17,4242,-10,60,70,10,1,10,10,-1,-10,60
131,18,18,4095,-40,40,80,40,1,20,20,0,-50,60
131,19,19,3600,60,80,20,60,1,-20,20,0.333333333,50,40
131,20,20,4183,40,80,40,40,1,0,0,-0.5,50,40
131,21,21,4219,-20,60,80,20,1,20,20,0.5,-10,60
131,22,22,3721,30,100,70,30,1,10,10,0.333333333,30,60
131,23,23,3277,40,60,20,40,1,-20,20,0.5,50,40
131,24,24,3590,0,80,80,0,1,20,20,,,60
131,25,25,3303,-40,0,40,40,1,0,0,0.75,-50,40
131,26,26,5799,-40,40,80,40,1,20,20,0.25,-50,60
131,27,27,3528,10,20,10,10,1,-30,30,2,10,40
131,28,28,4976,10,40,30,10,1,-10,10,,10,40
131,29,29,5002,-50,20,70,50,1,10,10,,-50,60
131,30,0,4691,0,50,50,0,0,-10,10,,,60
131,31,1,3667,-50,30,80,50,0,40,40,0.6,-50,40
131,32,2,3916,-30,20,50,30,0,10,10,1,-30,40
131,33,3,3852,-10,60,70,10,0,10,10,1,-10,60
131,34,4,4221,-20,40,60,20,0,0,0,-0.5,-10,60
131,35,5,3734,30,50,20,30,0,-20,20,1,30,40
131,36,6,3379,10,60,50,10,0,10,10,1,10,40
131,37,7,4164,0,70,70,0,0,10,10,,,60
131,38,8,3572,-20,40,60,20,0,20,20,0.5,-10,40
131,39,9,4903,50,80,30,50,0,-30,30,0.8,50,60
131,40,10,4899,10,60,50,10,0,10,10,-1,10,40
131,41,11,3485,-30,40,70,30,0,10,10,0.666666667,-30,60
131,42,12,3928,30,80,50,30,0,-10,10,0.666666667,30,60
131,43,13,3274,10,50,40,10,0,0,0,0,10,40
131,44,14,4427,-20,50,70,20,0,10,10,1,-10,60
131,45,15,4376,-10,30,40,10,0,0,0,0,-10,40
131,46,16,3437,10,60,50,10,0,-10,10,-1,10,60
131,47,17,3065,-20,20,40,20,0,0,0,-1,-10,40
131,48,18,3338,30,70,40,30,0,-20,20,0.333333333,30,60
131,49,19,3558,-20,40,60,20,0,20,20,1,-10,40
131,50,20,3496,0,50,50,0,0,-10,10,,,60
131,51,21,4314,40,80,40,40,0,-20,20,0.75,50,60
131,52,22,4185,10,50,40,10,0,0,0,2,10,40
131,53,23,3921,-30,30,60,30,0,20,20,1,-30,40
131,54,24,3294,0,70,70,0,0,10,10,,,60
131,55,25,6253,-10,20,30,10,0,-10,10,-1,-10,40
131,56,26,5430,0,40,40,0,0,0,0,,,40
131,57,27,4291,-10,60,70,10,0,10,10,-1,-10,60
131,58,28,3059,-40,40,80,40,0,20,20,,-50,60
131,59,29,3716,20,60,40,20,0,0,0,,10,40
132,0,0,3344,-35,20,55,35,1,15,15,-1,-30,40
132,1,1,2968,-25,40,65,25,1,5,5,0.8,-30,60
132,2,2,2906,-50,40,90,50,1,50,50,1,-50,40
132,3,3,3978,15,60,45,15,1,-15,15,3,10,60
132,4,4,3034,-40,0,40,40,1,0,0,-0.25,-50,40
132,5,5,3578,10,60,50,10,1,10,10,-0.5,10,40
132,6,6,2842,10,100,90,10,1,30,30,-0.5,10,60
132,7,7,3226,-65,20,85,65,1,25,25,0.384615385,-70,60
132,8,8,2746,35,80,45,35,1,5,5,-0.428571429,30,40
132,9,9,3723,20,80,60,20,1,0,0,1.5,10,60
132,10,10,3322,-10,80,90,10,1,30,30,5,-10,60
132,11,11,3099,10,40,30,10,1,-10,10,6,10,40
132,12,12,3259,-90,0,90,90,1,50,50,0.555555556,-70,40
132,13,13,2699,-20,20,40,20,1,-20,20,0.5,-10,60
132,14,14,4682,-20,20,40,20,1,0,0,0.5,-10,40
132,15,15,3003,10,40,30,10,1,-30,30,3,10,60
132,16,16,3691,30,60,30,30,1,-10,10,2.333333333,30,40
132,17,17,3145,0,60,60,0,1,0,0,,,60
132,18,18,2745,60,100,40,60,1,-20,20,0,50,60
132,19,19,3611,-20,80,100,20,1,60,60,2,-10,40
132,20,20,2920,-40,20,60,40,1,20,20,1,-50,40
132,21,21,3771,60,100,40,60,1,-20,20,0.833333333,50,60
132,22,22,3067,-10,80,90,10,1,30,30,9,-10,60
132,23,23,2985,-20,0,20,20,1,-20,20,0,-10,40
132,24,24,2715,40,40,0,40,1,-60,60,1,50,60
132,25,25,2683,60,80,20,60,1,-20,20,0.666666667,50,40
132,26,26,2986,20,60,40,20,1,-20,20,-2,10,60
132,27,27,3083,-20,40,60,20,1,20,20,1.5,-10,40
132,28,28,2714,30,60,30,30,1,-10,10,,30,40
132,29,29,2474,20,20,0,20,1,-60,60,,10,60
132,30,0,3771,-50,50,100,50,0,40,40,1,-50,60
132,31,1,2666,-10,20,30,10,0,-10,10,0,-10,40
132,32,2,3898,30,60,30,30,0,-10,10,1,30,40
132,33,3,2763,30,80,50,30,0,-10,10,0,30,60
132,34,4,2938,20,70,50,20,0,-10,10,-0.5,10,60
132,35,5,2826,-30,30,60,30,0,20,20,-1,-30,40
132,36,6,2843,-40,50,90,40,0,50,50,0.75,-50,40
132,37,7,2634,20,60,40,20,0,-20,20,-1,10,60
132,38,8,2858,-20,40,60,20,0,20,20,0,-10,40
132,39,9,2715,20,40,20,20,0,-40,40,3.5,10,60
132,40,10,3018,-10,50,60,10,0,20,20,6,-10,40
132,41,11,2746,-20,70,90,20,0,30,30,4.5,-10,60
132,42,12,2554,60,60,0,60,0,-60,60,1.666666667,50,60
132,43,13,2507,20,20,0,20,0,-40,40,2.5,10,40
132,44,14,2825,-20,80,100,20,0,40,40,3.5,-10,60
132,45,15,2970,-20,30,50,20,0,10,10,1,-10,40
132,46,16,2698,10,40,30,10,0,-30,30,3,10,60
132,47,17,2697,30,60,30,30,0,-10,10,1.666666667,30,40
132,48,18,2617,-10,50,60,10,0,0,0,5,-10,60
132,49,19,2714,-40,40,80,40,0,40,40,1.5,-50,40
132,50,20,3545,40,50,10,40,0,-50,50,1.25,50,60
132,51,21,2714,0,60,60,0,0,0,0,,,60
132,52,22,3290,0,20,20,0,0,-20,20,,,40
132,53,23,2922,0,30,30,0,0,-10,10,,,40
132,54,24,2682,20,70,50,20,0,-10,10,-0.5,10,60
132,55,25,3114,0,60,60,0,0,20,20,,,40
132,56,26,3035,20,50,30,20,0,-10,10,-0.5,10,40
132,57,27,2778,40,80,40,40,0,-20,20,0.5,50,60
132,58,28,2874,-20,40,60,20,0,0,0,,-10,60
132,59,29,2955,20,40,20,20,0,-20,20,,10,40
133,0,0,4370,-40,40,80,40,0,20,20,1.25,-50,60
133,1,1,5056,-20,40,60,20,0,20,20,0.5,-10,40
133,2,2,4031,-30,20,50,30,0,10,10,-0.666666667,-30,40
133,3,3,3353,30,60,30,30,0,-30,30,1,30,60
133,4,4,4147,10,70,60,10,0,0,0,2,10,60
133,5,5,3794,-40,30,70,40,0,30,30,0.5,-50,40
133,6,6,4076,10,60,50,10,0,10,10,-2,10,40
133,7,7,3001,-30,50,80,30,0,20,20,1,-30,60
133,8,8,3773,20,50,30,20,0,-10,10,0,10,40
133,9,9,4521,30,80,50,30,0,-10,10,0.666666667,30,60
133,10,10,3257,0,30,30,0,0,-10,10,,,40
133,11,11,3713,0,70,70,0,0,10,10,,,60
133,12,12,3162,-10,60,70,10,0,10,10,4,-10,60
133,13,13,2861,10,60,50,10,0,10,10,-3,10,40
133,14,14,3992,10,40,30,10,0,-30,30,2,10,60
133,15,15,3320,20,40,20,20,0,-20,20,2,10,40
133,16,16,3269,30,80,50,30,0,-10,10,1,30,60
133,17,17,2972,-40,20,60,40,0,20,20,0.5,-50,40
133,18,18,2894,-30,50,80,30,0,20,20,0.333333333,-30,60
133,19,19,3558,10,50,40,10,0,0,0,-2,10,40
133,20,20,2953,-20,50,70,20,0,10,10,1.5,-10,60
133,21,21,3576,20,60,40,20,0,-20,20,1.5,10,60
133,22,22,2909,10,30,20,10,0,-20,20,0,10,40
133,23,23,3337,0,20,20,0,0,-20,20,,,40
133,24,24,3131,0,70,70,0,0,10,10,,,60
133,25,25,2925,0,40,40,0,0,0,0,,,40
133,26,26,4185,20,60,40,20,0,0,0,0,10,40
133,27,27,5046,-10,40,50,10,0,-10,10,-1,-10,60
133,28,28,3688,20,80,60,20,0,0,0,,10,60
133,29,29,3583,10,50,40,10,0,0,0,,10,40
133,30,0,4450,-40,0,40,40,1,0,0,-0.75,-50,40
133,31,1,4180,40,60,20,40,1,-40,40,0.25,50,60
133,32,2,2858,-50,20,70,50,1,30,30,1,-50,40
133,33,3,3239,70,100,30,70,1,-30,30,0.142857143,70,60
133,34,4,3871,60,80,20,60,1,-20,20,0.666666667,50,40
133,35,5,3074,-20,40,60,20,1,20,20,-1,-10,40
133,36,6,2963,40,80,40,40,1,-20,20,0.75,50,60
133,37,7,2752,-50,20,70,50,1,10,10,0.6,-50,60
133,38,8,2923,-20,60,80,20,1,40,40,1,-10,40
133,39,9,2858,0,40,40,0,1,-20,20,,,60
133,40,10,3384,-10,40,50,10,1,-10,10,-3,-10,60
133,41,11,3928,0,60,60,0,1,20,20,,,40
133,42,12,2929,20,80,60,20,1,20,20,-1,10,40
133,43,13,4167,-20,60,80,20,1,20,20,2,-10,60
133,44,14,3649,0,40,40,0,1,0,0,,,40
133,45,15,4070,60,100,40,60,1,-20,20,0.166666667,50,60
133,46,16,3753,-30,20,50,30,1,10,10,0,-30,40
133,47,17,4409,-30,20,50,30,1,-10,10,0.333333333,-30,60
133,48,18,3831,40,80,40,40,1,-20,20,1.25,50,60
133,49,19,3385,-50,0,50,50,1,10,10,-0.4,-50,40
133,50,20,3398,-30,40,70,30,1,30,30,1,-30,40
133,51,21,4968,-50,40,90,50,1,30,30,0.6,-50,60
133,52,22,3388,20,80,60,20,1,0,0,-1,10,60
133,53,23,3607,-20,20,40,20,1,0,0,-0.5,-10,40
133,54,24,3660,-20,20,40,20,1,-20,20,-1,-10,60
133,55,25,3087,30,80,50,30,1,10,10,0,30,40
133,56,26,3422,0,60,60,0,1,0,0,,,60
133,57,27,4648,10,60,50,10,1,10,10,1,10,40
133,58,28,3929,-60,0,60,60,1,20,20,,-50,40
133,59,29,3315,30,100,70,30,1,10,10,,30,60
134,0,0,5003,0,70,70,0,0,10,10,,,60
134,1,1,4898,-20,20,40,20,0,0,0,-0.5,-10,40
134,2,2,5360,-20,30,50,20,0,10,10,0.5,-10,40
134,3,3,4572,0,80,80,0,0,20,20,,,60
134,4,4,4576,-10,60,70,10,0,10,10,-1,-10,60
134,5,5,4646,10,50,40,10,0,0,0,0,10,40
134,6,6,4874,0,40,40,0,0,0,0,,,40
134,7,7,4618,-30,50,80,30,0,20,20,0.333333333,-30,60
134,8,8,5241,30,60,30,30,0,-10,10,0.666666667,30,40
134,9,9,4656,-30,40,70,30,0,10,10,1,-30,60
134,10,10,5752,-30,20,50,30,0,10,10,0.333333333,-30,40
134,11,11,4544,40,80,40,40,0,-20,20,0.25,50,60
134,12,12,4761,0,50,50,0,0,-10,10,,,60
134,13,13,5986,-10,30,40,10,0,0,0,-1,-10,40
134,14,14,4968,0,40,40,0,0,-20,20,,,60
134,15,15,5036,-10,40,50,10,0,10,10,3,-10,40
134,16,16,4943,0,60,60,0,0,0,0,,,60
134,17,17,4764,30,50,20,30,0,-20,20,0.333333333,30,40
134,18,18,4700,30,70,40,30,0,-20,20,0,30,60
134,19,19,4746,30,60,30,30,0,-10,10,0.333333333,30,40
134,20,20,4944,30,70,40,30,0,-20,20,0.333333333,30,60
134,21,21,4773,10,60,50,10,0,-10,10,1,10,60
134,22,22,4817,10,50,40,10,0,0,0,0,10,40
134,23,23,4720,20,60,40,20,0,0,0,-0.5,10,40
134,24,24,5235,-10,50,60,10,0,0,0,-1,-10,60
134,25,25,4807,-10,20,30,10,0,-10,10,-1,-10,40
134,26,26,5172,-10,30,40,10,0,0,0,0,-10,40
134,27,27,4717,10,80,70,10,0,10,10,2,10,60
134,28,28,4731,-50,40,90,50,0,30,30,,-50,60
134,29,29,5215,0,40,40,0,0,0,0,,,40
134,30,0,5029,-50,0,50,50,1,10,10,0.2,-50,40
134,31,1,4807,10,60,50,10,1,-10,10,-1,10,60
134,32,2,5121,20,60,40,20,1,0,0,-1,10,40
134,33,3,4676,-20,20,40,20,1,-20,20,-0.5,-10,60
134,34,4,4475,0,20,20,0,1,-20,20,,,40
134,35,5,6783,40,80,40,40,1,0,0,-0.5,50,40
134,36,6,4619,-10,40,50,10,1,-10,10,2,-10,60
134,37,7,6037,70,100,30,70,1,-30,30,0.285714286,70,60
134,38,8,5023,20,40,20,20,1,-20,20,1,10,40
134,39,9,4597,30,80,50,30,1,-10,10,0.333333333,30,60
134,40,10,5022,40,100,60,40,1,0,0,-0.25,50,60
134,41,11,5150,0,40,40,0,1,0,0,,,40
134,42,12,5363,0,60,60,0,1,20,20,,,40
134,43,13,5009,-10,40,50,10,1,-10,10,3,-10,60
134,44,14,4873,-20,0,20,20,1,-20,20,-2,-10,40
134,45,15,4753,60,80,20,60,1,-40,40,0.666666667,50,60
134,46,16,5115,-40,20,60,40,1,20,20,-0.5,-50,40
134,47,17,4913,-40,20,60,40,1,0,0,-0.5,-50,60
134,48,18,4906,-20,60,80,20,1,20,20,1,-10,60
134,49,19,4325,0,80,80,0,1,40,40,,,40
134,50,20,5102,20,40,20,20,1,-20,20,1,10,40
134,51,21,4840,0,60,60,0,1,0,0,,,60
134,52,22,4330,0,80,80,0,1,20,20,,,60
134,53,23,4813,-20,20,40,20,1,0,0,0,-10,40
134,54,24,4484,-60,20,80,60,1,20,20,0.333333333,-50,60
134,55,25,5194,-40,0,40,40,1,0,0,0.5,-50,40
134,56,26,4630,40,100,60,40,1,0,0,1,50,60
134,57,27,4593,60,80,20,60,1,-20,20,0.666666667,50,40
134,58,28,4495,0,60,60,0,1,20,20,,,40
134,59,29,4889,-60,40,100,60,1,40,40,,-50,60
135,0,0,4249,30,80,50,30,0,-10,10,0.666666667,30,60
135,1,1,3935,-20,20,40,20,0,0,0,1,-10,40
135,2,2,4046,10,30,20,10,0,-20,20,1,10,40
135,3,3,4068,0,70,70,0,0,10,10,,,60
135,4,4,3869,-30,40,70,30,0,10,10,-0.666666667,-30,60
135,5,5,5380,30,60,30,30,0,-10,10,0.166666667,30,40
135,6,6,4150,15,50,35,15,0,-5,5,0.333333333,10,40
135,7,7,3769,-30,60,90,30,0,30,30,0.5,-30,60
135,8,8,4843,0,40,40,0,0,0,0,,,40
135,9,9,3774,-25,50,75,25,0,15,15,0.6,-30,60
135,10,10,3511,25,60,35,25,0,-5,5,-0.6,30,40
135,11,11,3803,0,60,60,0,0,0,0,,,60
135,12,12,3927,-25,40,65,25,0,5,5,-0.6,-30,60
135,13,13,3643,30,50,20,30,0,-20,20,0.666666667,30,40
135,14,14,3415,-30,50,80,30,0,20,20,-0.5,-30,60
135,15,15,3342,-20,20,40,20,0,0,0,0.5,-10,40
135,16,16,4636,-25,70,95,25,0,35,35,1.4,-30,60
135,17,17,4193,10,40,30,10,0,-10,10,1,10,40
135,18,18,3809,20,80,60,20,0,0,0,-0.5,10,60
135,19,19,3967,-10,30,40,10,0,0,0,0.3,-10,40
135,20,20,3220,10,60,50,10,0,-10,10,0.6,10,60
135,21,21,3890,-16,40,56,16,0,-4,4,-1.5,-10,60
135,22,22,3567,23,60,37,23,0,-3,3,0.130434783,30,40
135,23,23,3408,10,50,40,10,0,0,0,0,10,40
135,24,24,3300,0,80,80,0,0,20,20,,,60
135,25,25,3929,0,40,40,0,0,0,0,,,40
135,26,26,3112,-15,20,35,15,0,-5,5,0,-10,40
135,27,27,3497,20,70,50,20,0,-10,10,1.25,10,60
135,28,28,3223,-25,50,75,25,0,15,15,,-30,60
135,29,29,3526,-5,30,35,5,0,-5,5,,-10,40
135,30,0,4640,-10,40,50,10,1,10,10,2,-10,40
135,31,1,3932,30,100,70,30,1,10,10,0.666666667,30,60
135,32,2,4580,-30,0,30,30,1,-10,10,0.333333333,-30,40
135,33,3,3241,-10,80,90,10,1,30,30,2,-10,60
135,34,4,3352,40,60,20,40,1,-20,20,-0.25,50,40
135,35,5,4106,70,80,10,70,1,-30,30,0.357142857,70,40
135,36,6,3244,-50,20,70,50,1,10,10,0.4,-50,60
135,37,7,3325,10,60,50,10,1,-10,10,1,10,60
135,38,8,3491,-15,20,35,15,1,-5,5,-0.333333333,-10,40
135,39,9,3783,-20,40,60,20,1,0,0,-0.5,-10,60
135,40,10,4715,10,80,70,10,1,10,10,0,10,60
135,41,11,4304,-40,0,40,40,1,0,0,0.75,-50,40
135,42,12,3906,30,40,10,30,1,-30,30,1,30,40
135,43,13,4372,-30,40,70,30,1,10,10,0.333333333,-30,60
135,44,14,4112,20,60,40,20,1,0,0,-1,10,40
135,45,15,3589,40,100,60,40,1,0,0,0,50,60
135,46,16,4049,0,20,20,0,1,-20,20,,,40
135,47,17,3431,0,60,60,0,1,0,0,,,60
135,48,18,4918,-30,20,50,30,1,-10,10,-0.833333333,-30,60
135,49,19,4810,35,80,45,35,1,5,5,-0.428571429,30,40
135,50,20,4834,-30,0,30,30,1,-10,10,0.333333333,-30,40
135,51,21,3892,25,100,75,25,1,15,15,-0.2,30,60
135,52,22,4618,10,80,70,10,1,10,10,1,10,60
135,53,23,4405,0,20,20,0,1,-20,20,,,40
135,54,24,3853,-20,60,80,20,1,20,20,1,-10,60
135,55,25,3438,30,40,10,30,1,-30,30,1,30,40
135,56,26,3497,-40,20,60,40,1,0,0,-0.25,-50,60
135,57,27,4732,20,60,40,20,1,0,0,-1,10,40
135,58,28,4106,60,80,20,60,1,-20,20,,50,40
135,59,29,3643,-30,40,70,30,1,10,10,,-30,60
136,0,0,3680,10,60,50,10,0,-10,10,3,10,60
136,1,1,2713,-10,30,40,10,0,0,0,2,-10,40
136,2,2,3055,20,40,20,20,0,-20,20,1.5,10,40
136,3,3,2752,-10,70,80,10,0,20,20,3,-10,60
136,4,4,3074,-10,40,50,10,0,-10,10,-2,-10,60
136,5,5,3006,0,50,50,0,0,10,10,,,40
136,6,6,2719,-20,20,40,20,0,0,0,0.5,-10,40
136,7,7,2776,10,80,70,10,0,10,10,2,10,60
136,8,8,2886,30,60,30,30,0,-10,10,1,30,40
136,9,9,2658,-40,50,90,40,0,30,30,0.5,-50,60
136,10,10,2529,-30,30,60,30,0,20,20,0.333333333,-30,40
136,11,11,2850,10,80,70,10,0,10,10,-1,10,60
136,12,12,3138,10,70,60,10,0,0,0,2,10,60
136,13,13,2851,10,60,50,10,0,10,10,0,10,40
136,14,14,3312,-40,40,80,40,0,20,20,1,-50,60
136,15,15,3138,-10,40,50,10,0,10,10,1,-10,40
136,16,16,3234,20,60,40,20,0,-20,20,1.5,10,60
136,17,17,2698,-20,20,40,20,0,0,0,-1,-10,40
136,18,18,3207,-20,50,70,20,0,10,10,-0.5,-10,60
136,19,19,2833,-10,50,60,10,0,20,20,1,-10,40
136,20,20,2600,0,80,80,0,0,20,20,,,60
136,21,21,3689,20,60,40,20,0,-20,20,1.5,10,60
136,22,22,2713,-20,30,50,20,0,10,10,1,-10,40
136,23,23,2804,10,40,30,10,0,-10,10,-1,10,40
136,24,24,2515,-30,40,70,30,0,10,10,0.333333333,-30,60
136,25,25,2609,30,50,20,30,0,-20,20,1.333333333,30,40
136,26,26,2959,0,60,60,0,0,20,20,,,40
136,27,27,3241,10,70,60,10,0,0,0,3,10,60
136,28,28,2584,-40,50,90,40,0,30,30,,-50,60
136,29,29,2616,-20,20,40,20,0,0,0,,-10,40
136,30,0,4914,-30,20,50,30,1,10,10,0.333333333,-30,40
136,31,1,2850,50,100,50,50,1,-10,10,0.6,50,60
136,32,2,3217,40,80,40,40,1,0,0,0.25,50,40
136,33,3,2742,-40,40,80,40,1,20,20,1.25,-50,60
136,34,4,3139,-10,40,50,10,1,10,10,-3,-10,40
136,35,5,2986,-20,60,80,20,1,40,40,3,-10,40
136,36,6,2872,50,80,30,50,1,-30,30,0.4,50,60
136,37,7,4056,-30,20,50,30,1,-10,10,-1,-30,60
136,38,8,3817,-20,0,20,20,1,-20,20,-1.5,-10,40
136,39,9,4089,-20,60,80,20,1,20,20,1.5,-10,60
136,40,10,3538,10,60,50,10,1,-10,10,-1,10,60
136,41,11,3219,10,60,50,10,1,10,10,2,10,40
136,42,12,3393,10,80,70,10,1,30,30,-3,10,40
136,43,13,4074,60,100,40,60,1,-20,20,0.333333333,50,60
136,44,14,4177,-20,20,40,20,1,0,0,-1,-10,40
136,45,15,3450,-40,20,60,40,1,0,0,1,-50,60
136,46,16,3499,-20,40,60,20,1,20,20,-0.5,-10,40
136,47,17,2673,60,80,20,60,1,-40,40,0.666666667,50,60
136,48,18,3359,-20,40,60,20,1,0,0,1,-10,60
136,49,19,2769,-70,0,70,70,1,30,30,0.714285714,-70,40
136,50,20,2705,40,60,20,40,1,-20,20,0.5,50,40
136,51,21,2911,60,100,40,60,1,-20,20,0.333333333,50,60
136,52,22,3154,-40,20,60,40,1,0,0,-0.25,-50,60
136,53,23,3214,-40,0,40,40,1,0,0,0.25,-50,40
136,54,24,2802,-10,60,70,10,1,10,10,1,-10,60
136,55,25,2770,10,40,30,10,1,-10,10,1,10,40
136,56,26,2876,-20,40,60,20,1,0,0,-1.5,-10,60
136,57,27,2683,-20,20,40,20,1,0,0,-0.5,-10,40
136,58,28,3520,30,80,50,30,1,10,10,,30,40
136,59,29,3856,-10,80,90,10,1,30,30,,-10,60